//MAP CONVERTED BY dmm2tgm.py THIS HEADER COMMENT PREVENTS RECONVERSION, DO NOT REMOVE
"a" = (
/turf/template_noop,
/area/template_noop)
"c" = (
/obj/item/clockwork/alloy_shards/small,
/turf/open/floor/plating/asteroid/basalt/lava_land_surface,
/area/lavaland/surface/outdoors/unexplored)
"d" = (
/turf/open/floor/plating/asteroid/basalt/lava_land_surface,
/area/lavaland/surface/outdoors/unexplored)
"f" = (
/turf/closed/mineral/volcanic/lava_land_surface,
/area/lavaland/surface/outdoors/unexplored)
"g" = (
/obj/item/clockwork/alloy_shards/medium/gear_bit,
/turf/open/floor/plating/asteroid/basalt/lava_land_surface,
/area/lavaland/surface/outdoors/unexplored)
"i" = (
/obj/structure/grille/ratvar/broken,
/turf/open/floor/plating/asteroid/basalt/lava_land_surface,
/area/lavaland/surface/outdoors/unexplored)
"j" = (
/turf/closed/wall/clockwork,
/area/lavaland/surface/outdoors/unexplored)
"k" = (
/obj/item/clockwork/alloy_shards/small,
/turf/open/floor/clockwork{
	initial_gas_mix = "LAVALAND_ATMOS"
	},
/area/lavaland/surface/outdoors/unexplored)
"l" = (
/turf/open/lava/smooth/lava_land_surface,
/area/lavaland/surface/outdoors/unexplored)
"m" = (
/obj/item/clockwork/alloy_shards/medium,
/turf/open/floor/plating/asteroid/basalt/lava_land_surface,
/area/lavaland/surface/outdoors/unexplored)
"n" = (
/obj/item/clockwork/component/belligerent_eye/blind_eye,
/turf/open/floor/plating/asteroid/basalt/lava_land_surface,
/area/lavaland/surface/outdoors/unexplored)
"o" = (
/obj/item/clockwork/alloy_shards/large,
/turf/open/floor/plating/asteroid/basalt/lava_land_surface,
/area/lavaland/surface/outdoors/unexplored)
"p" = (
/obj/item/clockwork/alloy_shards/medium,
/turf/open/floor/clockwork{
	initial_gas_mix = "LAVALAND_ATMOS"
	},
/area/lavaland/surface/outdoors/unexplored)
"q" = (
/obj/structure/lattice/catwalk/clockwork,
/turf/open/lava/smooth/lava_land_surface,
/area/lavaland/surface/outdoors/unexplored)
"r" = (
/obj/structure/lattice/clockwork,
/turf/open/floor/plating/asteroid/basalt/lava_land_surface,
/area/lavaland/surface/outdoors/unexplored)
"s" = (
/obj/item/clockwork/alloy_shards/large,
/turf/open/floor/clockwork{
	initial_gas_mix = "LAVALAND_ATMOS"
	},
/area/lavaland/surface/outdoors/unexplored)
"t" = (
/obj/item/stack/tile/brass,
/turf/open/floor/plating/asteroid/basalt/lava_land_surface,
/area/lavaland/surface/outdoors/unexplored)
"u" = (
/obj/structure/grille/ratvar,
/turf/open/floor/clockwork{
	initial_gas_mix = "LAVALAND_ATMOS"
	},
/area/lavaland/surface/outdoors/unexplored)
"v" = (
/obj/item/clockwork/alloy_shards/medium,
/obj/structure/lattice/clockwork,
/turf/open/floor/plating/asteroid/basalt/lava_land_surface,
/area/lavaland/surface/outdoors/unexplored)
"w" = (
/obj/structure/grille/ratvar/broken,
/turf/open/floor/clockwork{
	initial_gas_mix = "LAVALAND_ATMOS"
	},
/area/lavaland/surface/outdoors/unexplored)
"x" = (
/obj/item/stack/tile/brass,
/turf/open/floor/clockwork{
	initial_gas_mix = "LAVALAND_ATMOS"
	},
/area/lavaland/surface/outdoors/unexplored)
"y" = (
/obj/item/clockwork/component/geis_capacitor/fallen_armor,
/turf/open/floor/clockwork{
	initial_gas_mix = "LAVALAND_ATMOS"
	},
/area/lavaland/surface/outdoors/unexplored)
"z" = (
/turf/open/floor/clockwork{
	initial_gas_mix = "LAVALAND_ATMOS"
	},
/area/lavaland/surface/outdoors/unexplored)
"A" = (
/obj/item/clockwork/alloy_shards/clockgolem_remains,
/turf/open/floor/clockwork{
	initial_gas_mix = "LAVALAND_ATMOS"
	},
/area/lavaland/surface/outdoors/unexplored)
"B" = (
/obj/item/clockwork/weapon/ratvarian_spear,
/turf/open/floor/clockwork{
	initial_gas_mix = "LAVALAND_ATMOS"
	},
/area/lavaland/surface/outdoors/unexplored)
"C" = (
/obj/item/clockwork/alloy_shards/medium/gear_bit,
/turf/open/floor/clockwork{
	initial_gas_mix = "LAVALAND_ATMOS"
	},
/area/lavaland/surface/outdoors/unexplored)
"D" = (
/obj/structure/grille/ratvar,
/turf/open/floor/plating/asteroid/basalt/lava_land_surface,
/area/lavaland/surface/outdoors/unexplored)
"E" = (
/obj/item/clockwork/alloy_shards/clockgolem_remains,
/turf/open/floor/plating/asteroid/basalt/lava_land_surface,
/area/lavaland/surface/outdoors/unexplored)
"F" = (
/obj/structure/dead_ratvar,
/turf/open/floor/clockwork{
	initial_gas_mix = "LAVALAND_ATMOS"
	},
/area/lavaland/surface/outdoors/unexplored)
"G" = (
/obj/item/stack/tile/brass/fifty,
/turf/open/floor/plating/asteroid/basalt/lava_land_surface,
/area/lavaland/surface/outdoors/unexplored)

(1,1,1) = {"
a
a
a
a
a
a
a
a
a
a
a
a
a
d
s
z
d
a
a
a
a
a
a
a
"}
(2,1,1) = {"
a
a
a
a
a
a
a
o
d
a
z
d
r
c
j
x
d
d
g
a
a
a
a
a
"}
(3,1,1) = {"
a
a
a
a
a
a
f
d
l
d
v
d
p
w
j
j
c
l
d
d
a
a
a
a
"}
(4,1,1) = {"
a
a
a
a
a
a
f
l
l
r
d
d
l
j
j
j
p
l
d
z
c
r
a
a
"}
(5,1,1) = {"
a
a
a
a
a
d
l
l
p
z
c
l
l
l
j
l
d
l
l
D
z
r
a
a
"}
(6,1,1) = {"
a
a
a
z
c
z
m
l
l
c
l
l
l
l
w
l
l
l
m
c
z
f
a
a
"}
(7,1,1) = {"
a
a
d
d
d
l
l
l
l
z
d
l
l
l
l
l
l
l
l
c
f
f
d
a
"}
(8,1,1) = {"
a
z
z
g
c
d
l
l
l
l
n
z
r
l
l
d
l
l
l
l
f
d
a
a
"}
(9,1,1) = {"
a
d
c
d
d
l
l
l
l
t
z
d
z
w
p
d
g
l
l
d
d
d
d
a
"}
(10,1,1) = {"
d
z
l
l
l
l
l
l
d
d
p
r
F
d
z
A
d
l
l
l
m
l
l
a
"}
(11,1,1) = {"
c
i
j
j
l
l
l
l
l
d
z
k
z
z
z
r
l
l
l
l
l
l
d
a
"}
(12,1,1) = {"
d
j
j
j
z
l
l
d
l
q
r
z
z
z
c
q
l
d
l
l
d
z
o
a
"}
(13,1,1) = {"
x
k
d
l
l
l
d
p
s
r
z
z
z
z
z
z
z
l
l
l
l
d
d
a
"}
(14,1,1) = {"
d
d
d
m
l
l
l
d
z
z
k
z
z
z
z
z
c
d
l
l
d
d
z
d
"}
(15,1,1) = {"
d
d
d
l
l
l
l
z
z
z
z
z
z
z
k
B
z
l
l
l
l
d
d
a
"}
(16,1,1) = {"
f
l
l
l
l
l
l
q
d
z
z
z
z
z
z
s
d
l
l
l
l
f
f
a
"}
(17,1,1) = {"
d
d
d
l
l
l
d
l
q
r
z
z
z
z
z
d
s
r
l
r
l
l
d
a
"}
(18,1,1) = {"
d
z
l
l
l
d
d
z
d
z
z
z
z
z
r
k
d
C
r
z
d
d
m
d
"}
(19,1,1) = {"
d
d
l
l
l
l
z
d
z
z
z
z
z
z
z
r
j
z
c
z
r
z
d
d
"}
(20,1,1) = {"
d
l
l
l
l
d
d
p
z
c
z
k
z
z
o
d
l
l
l
d
E
r
G
o
"}
(21,1,1) = {"
g
d
l
l
l
l
l
r
z
r
z
z
z
z
y
l
l
l
l
l
l
j
j
r
"}
(22,1,1) = {"
c
c
d
l
l
d
z
z
t
d
z
z
z
z
z
m
d
l
l
l
z
j
j
j
"}
(23,1,1) = {"
d
z
m
n
d
z
l
o
j
u
r
p
z
r
z
d
l
l
l
d
d
w
r
d
"}
(24,1,1) = {"
a
a
d
d
l
l
l
j
j
q
p
z
m
x
z
j
j
l
l
c
l
l
d
a
"}
(25,1,1) = {"
a
a
a
l
l
l
l
j
l
l
d
z
r
x
z
l
l
l
l
l
l
a
a
a
"}
(26,1,1) = {"
a
a
a
c
d
l
l
l
l
l
l
g
q
d
z
l
l
l
c
m
d
a
a
a
"}
(27,1,1) = {"
a
a
a
d
z
d
l
l
l
l
l
l
l
l
l
l
l
l
l
d
a
a
a
a
"}
(28,1,1) = {"
a
a
a
a
c
d
l
d
l
l
l
l
l
l
l
l
d
l
f
a
a
a
a
a
"}
(29,1,1) = {"
a
a
a
a
d
d
f
c
d
l
c
l
l
l
l
c
o
l
d
a
a
a
a
a
"}
(30,1,1) = {"
a
a
a
a
a
g
c
d
l
l
d
m
l
d
l
f
d
a
a
a
a
a
a
a
"}
(31,1,1) = {"
a
a
a
a
a
a
a
d
l
d
a
d
l
c
f
f
a
a
a
a
a
a
a
a
"}
(32,1,1) = {"
a
a
a
a
a
a
a
a
a
a
a
a
a
a
c
a
a
a
a
a
a
a
a
a
"}
