//MAP CONVERTED BY dmm2tgm.py THIS HEADER COMMENT PREVENTS RECONVERSION, DO NOT REMOVE
"aa" = (
/turf/closed/mineral/volcanic/lava_land_surface,
/area/lavaland/surface/outdoors)
"ab" = (
/turf/open/floor/plating/asteroid/basalt/lava_land_surface,
/area/lavaland/surface/outdoors)
"ad" = (
/obj/structure/window/spawner/east,
/obj/structure/flora/ausbushes/palebush,
/obj/structure/flora/ausbushes/ppflowers,
/area/ruin/powered/seedvault)
"ah" = (
/turf/open/floor/plasteel/freezer,
/area/ruin/powered/seedvault)
"ai" = (
/obj/machinery/reagentgrinder{
	pixel_y = 5
	},
/obj/structure/table/glass,
/obj/machinery/airalarm/directional/north,
/turf/open/floor/plasteel/dark,
/area/ruin/powered/seedvault)
"aj" = (
/obj/machinery/light,
/obj/machinery/atmospherics/pipe/simple/supply/hidden{
	dir = 4
	},
/turf/open/floor/plasteel/freezer,
/area/ruin/powered/seedvault)
"ak" = (
/obj/machinery/door/airlock/glass_large,
/turf/open/floor/plasteel/freezer,
/area/ruin/powered/seedvault)
"an" = (
/obj/effect/decal/cleanable/dirt,
/turf/open/floor/plasteel/freezer,
/area/ruin/powered/seedvault)
"ap" = (
/obj/machinery/chem_dispenser/mutagensaltpeter,
/turf/open/floor/mineral/plastitanium,
/area/ruin/powered/seedvault)
"aw" = (
/obj/structure/sink{
	dir = 4;
	pixel_x = -12;
	pixel_y = 2
	},
/obj/machinery/light,
/turf/open/floor/plasteel/dark,
/area/ruin/powered/seedvault)
"ay" = (
/obj/machinery/door/airlock/titanium,
/turf/open/floor/vault,
/area/ruin/powered/seedvault)
"aB" = (
/obj/machinery/hydroponics/constructable,
/turf/open/floor/mineral/plastitanium,
/area/ruin/powered/seedvault)
"aC" = (
/obj/effect/decal/cleanable/dirt,
/turf/open/floor/mineral/titanium/blue,
/area/ruin/powered/seedvault)
"aE" = (
/obj/effect/decal/cleanable/dirt,
/obj/machinery/atmospherics/pipe/simple/supply/hidden,
/turf/open/floor/mineral/titanium/blue,
/area/ruin/powered/seedvault)
"aH" = (
/obj/structure/table/reinforced,
/turf/open/floor/mineral/plastitanium,
/area/ruin/powered/seedvault)
"aK" = (
/obj/structure/window/spawner/east,
/obj/structure/flora/ausbushes/fernybush,
/obj/structure/flora/ausbushes/ywflowers,
/obj/structure/flora/ausbushes/sparsegrass,
/obj/effect/decal/cleanable/glass,
/area/ruin/powered/seedvault)
"aP" = (
/obj/machinery/light,
/turf/open/floor/plasteel/freezer,
/area/ruin/powered/seedvault)
"aQ" = (
/turf/closed/wall/r_wall,
/area/ruin/powered/seedvault)
"aX" = (
/obj/machinery/light{
	dir = 8
	},
/obj/machinery/hydroponics/constructable,
/obj/effect/decal/cleanable/dirt,
/turf/open/floor/mineral/plastitanium,
/area/ruin/powered/seedvault)
"bk" = (
/obj/structure/sink{
	dir = 4;
	pixel_x = -12;
	pixel_y = 2
	},
/obj/machinery/light{
	dir = 1
	},
/obj/effect/decal/cleanable/cobweb,
/turf/open/floor/plasteel/dark,
/area/ruin/powered/seedvault)
"bs" = (
/obj/structure/table/wood,
/obj/item/gun/energy/floragun{
	pixel_y = 6
	},
/obj/item/gun/energy/floragun{
	pixel_y = 4
	},
/obj/item/gun/energy/floragun{
	pixel_y = 2
	},
/obj/item/gun/energy/floragun,
/obj/effect/decal/cleanable/cobweb/cobweb2,
/turf/open/floor/plasteel/dark,
/area/ruin/powered/seedvault)
"dq" = (
/obj/machinery/atmospherics/components/unary/vent_pump/on{
	dir = 1
	},
/turf/open/floor/mineral/titanium/blue,
/area/ruin/powered/seedvault)
"eg" = (
/obj/machinery/door/airlock/titanium,
/obj/machinery/atmospherics/pipe/simple/supply/hidden,
/turf/open/floor/vault,
/area/ruin/powered/seedvault)
"eL" = (
/obj/structure/table/wood,
/obj/item/lighter,
/obj/item/lighter,
/obj/item/storage/fancy/rollingpapers,
/obj/item/storage/fancy/rollingpapers,
/obj/item/storage/fancy/rollingpapers,
/obj/item/storage/fancy/rollingpapers,
/turf/open/floor/plasteel/dark,
/area/ruin/powered/seedvault)
"gs" = (
/obj/machinery/biogenerator,
/obj/effect/decal/cleanable/dirt,
/turf/open/floor/mineral/plastitanium,
/area/ruin/powered/seedvault)
"hg" = (
/obj/machinery/atmospherics/components/unary/tank/air{
	dir = 4
	},
/turf/open/floor/plasteel/freezer,
/area/ruin/powered/seedvault)
"jC" = (
/obj/structure/closet/crate/hydroponics,
/obj/structure/beebox,
/obj/item/melee/flyswatter,
/obj/item/honey_frame,
/obj/item/honey_frame,
/obj/item/honey_frame,
/obj/item/queen_bee/bought,
/obj/item/clothing/head/beekeeper_head,
/obj/item/clothing/suit/beekeeper_suit,
/obj/effect/decal/cleanable/cobweb,
/turf/open/floor/vault,
/area/ruin/powered/seedvault)
"kZ" = (
/obj/machinery/light{
	dir = 4
	},
/obj/machinery/hydroponics/constructable,
/obj/effect/decal/cleanable/dirt,
/turf/open/floor/mineral/plastitanium,
/area/ruin/powered/seedvault)
"lk" = (
/obj/machinery/seed_extractor,
/turf/open/floor/mineral/plastitanium,
/area/ruin/powered/seedvault)
"ll" = (
/turf/open/floor/mineral/plastitanium,
/area/ruin/powered/seedvault)
"lz" = (
/obj/effect/decal/cleanable/glass,
/turf/open/floor/plating/asteroid/basalt/lava_land_surface,
/area/lavaland/surface/outdoors)
"lT" = (
/obj/machinery/door/airlock/vault,
/obj/machinery/atmospherics/pipe/simple/supply/hidden,
/turf/open/floor/plasteel/freezer,
/area/ruin/powered/seedvault)
"lV" = (
/obj/machinery/door/airlock/vault,
/obj/effect/mapping_helpers/airlock/cyclelink_helper{
	dir = 1
	},
/turf/open/floor/plasteel/dark,
/area/ruin/powered/seedvault)
"mg" = (
/obj/structure/window/spawner/east,
/obj/structure/flora/ausbushes/sparsegrass,
/area/ruin/powered/seedvault)
"mj" = (
/obj/machinery/disposal/bin,
/obj/structure/disposalpipe/trunk{
	dir = 4
	},
/turf/open/floor/mineral/titanium/blue,
/area/ruin/powered/seedvault)
"mz" = (
/obj/structure/disposalpipe/trunk{
	dir = 8
	},
/obj/structure/flora/ausbushes/fullgrass,
/obj/structure/disposaloutlet,
/obj/structure/flora/ausbushes/fullgrass,
/obj/machinery/light{
	dir = 1
	},
/area/ruin/powered/seedvault)
"ni" = (
/turf/open/floor/vault,
/area/ruin/powered/seedvault)
"of" = (
/obj/machinery/atmospherics/components/unary/vent_pump/on,
/turf/open/floor/plasteel/freezer,
/area/ruin/powered/seedvault)
"oz" = (
/obj/machinery/atmospherics/pipe/simple/supply/hidden,
/turf/open/floor/plasteel/freezer,
/area/ruin/powered/seedvault)
"po" = (
/obj/structure/table/wood,
/turf/open/floor/vault,
/area/ruin/powered/seedvault)
"pM" = (
/obj/structure/window/spawner,
/obj/structure/flora/ausbushes/ppflowers,
/obj/structure/flora/ausbushes/genericbush,
/obj/structure/flora/ausbushes/brflowers,
/area/ruin/powered/seedvault)
"rk" = (
/obj/structure/disposalpipe/segment{
	dir = 9
	},
/turf/closed/wall/r_wall,
/area/ruin/powered/seedvault)
"sb" = (
/obj/machinery/light{
	dir = 1
	},
/obj/effect/mob_spawn/human/seed_vault,
/turf/open/floor/plasteel/freezer,
/area/ruin/powered/seedvault)
"sd" = (
/obj/structure/disposalpipe/segment{
	dir = 4
	},
/turf/open/floor/mineral/titanium/blue,
/area/ruin/powered/seedvault)
"sx" = (
/obj/structure/reagent_dispensers/watertank/high,
/turf/open/floor/plasteel/dark,
/area/ruin/powered/seedvault)
"sG" = (
/obj/machinery/atmospherics/pipe/manifold4w/supply/hidden,
/turf/open/floor/plasteel/freezer,
/area/ruin/powered/seedvault)
"sR" = (
/obj/structure/disposalpipe/segment{
	dir = 4
	},
/obj/structure/table/reinforced,
/turf/open/floor/mineral/plastitanium,
/area/ruin/powered/seedvault)
"uE" = (
/obj/item/reagent_containers/glass/beaker/bluespace,
/obj/item/reagent_containers/glass/beaker/bluespace,
/obj/item/reagent_containers/glass/beaker/bluespace,
/obj/item/reagent_containers/glass/beaker/bluespace,
/obj/structure/table/wood,
/turf/open/floor/plasteel/dark,
/area/ruin/powered/seedvault)
"vY" = (
/obj/structure/table/wood,
/obj/item/storage/bag/plants{
	pixel_x = -5
	},
/obj/item/storage/bag/plants{
	pixel_y = -5
	},
/obj/item/storage/bag/plants{
	pixel_y = 5
	},
/obj/item/storage/bag/plants{
	pixel_x = 5
	},
/turf/open/floor/plasteel/dark,
/area/ruin/powered/seedvault)
"wp" = (
/obj/machinery/light{
	dir = 1
	},
/obj/effect/mob_spawn/human/seed_vault,
/obj/effect/decal/cleanable/cobweb/cobweb2,
/turf/open/floor/plasteel/freezer,
/area/ruin/powered/seedvault)
"xG" = (
/obj/machinery/light{
	dir = 1
	},
/turf/open/floor/vault,
/area/ruin/powered/seedvault)
"xQ" = (
/turf/open/floor/plasteel/dark,
/area/ruin/powered/seedvault)
"yU" = (
/obj/effect/decal/cleanable/food/plant_smudge,
/obj/machinery/atmospherics/components/unary/vent_pump/on{
	dir = 1
	},
/turf/open/floor/vault,
/area/ruin/powered/seedvault)
"zY" = (
/obj/machinery/light{
	dir = 4
	},
/obj/structure/reagent_dispensers/watertank/high,
/turf/open/floor/plasteel/dark,
/area/ruin/powered/seedvault)
"Ay" = (
/obj/machinery/light,
/obj/machinery/hydroponics/constructable,
/obj/effect/decal/cleanable/dirt,
/obj/effect/decal/cleanable/dirt,
/turf/open/floor/mineral/plastitanium,
/area/ruin/powered/seedvault)
"AK" = (
/obj/structure/disposalpipe/segment{
	dir = 6
	},
/turf/closed/wall/r_wall,
/area/ruin/powered/seedvault)
"BJ" = (
/obj/structure/closet/crate/hydroponics,
/obj/structure/beebox,
/obj/item/melee/flyswatter,
/obj/item/honey_frame,
/obj/item/honey_frame,
/obj/item/honey_frame,
/obj/item/queen_bee/bought,
/obj/item/clothing/head/beekeeper_head,
/obj/item/clothing/suit/beekeeper_suit,
/obj/machinery/light{
	dir = 8
	},
/turf/open/floor/vault,
/area/ruin/powered/seedvault)
"BK" = (
/obj/structure/sink{
	dir = 8;
	pixel_x = 11
	},
/obj/machinery/light{
	dir = 1
	},
/turf/open/floor/plasteel/dark,
/area/ruin/powered/seedvault)
"CG" = (
/turf/closed/mineral/volcanic/lava_land_surface,
/area/ruin/powered/seedvault)
"FC" = (
/obj/structure/closet/crate/hydroponics,
/obj/item/clothing/under/rank/civilian/hydroponics,
/obj/item/clothing/under/rank/civilian/hydroponics,
/obj/item/clothing/under/rank/civilian/hydroponics,
/obj/item/clothing/under/rank/civilian/hydroponics,
/obj/effect/decal/cleanable/cobweb,
/turf/open/floor/plasteel/dark,
/area/ruin/powered/seedvault)
"GB" = (
/obj/machinery/atmospherics/pipe/manifold/supply/hidden,
/turf/open/floor/plasteel/freezer,
/area/ruin/powered/seedvault)
"He" = (
/obj/machinery/chem_master/condimaster,
/turf/open/floor/mineral/plastitanium,
/area/ruin/powered/seedvault)
"Hw" = (
/obj/structure/closet/crate/hydroponics,
/obj/item/cultivator,
/obj/item/cultivator,
/obj/item/cultivator,
/obj/item/cultivator,
/obj/item/shovel/spade,
/obj/item/shovel/spade,
/obj/item/shovel/spade,
/obj/item/shovel/spade,
/obj/item/hatchet,
/obj/item/hatchet,
/obj/item/hatchet,
/obj/item/hatchet,
/turf/open/floor/plasteel/dark,
/area/ruin/powered/seedvault)
"HU" = (
/obj/structure/closet/crate/hydroponics,
/obj/item/soap/homemade,
/obj/item/soap/homemade,
/turf/open/floor/plasteel/dark,
/area/ruin/powered/seedvault)
"HV" = (
/obj/structure/loom,
/turf/open/floor/plasteel/dark,
/area/ruin/powered/seedvault)
"IL" = (
/obj/machinery/light{
	dir = 4
	},
/turf/open/floor/plasteel/dark,
/area/ruin/powered/seedvault)
"Jr" = (
/obj/machinery/door/airlock/external,
/obj/effect/mapping_helpers/airlock/cyclelink_helper,
/turf/open/floor/plasteel/dark,
/area/ruin/powered/seedvault)
"KQ" = (
/obj/effect/mob_spawn/human/seed_vault,
/obj/machinery/light{
	dir = 1
	},
/turf/open/floor/plasteel/freezer,
/area/ruin/powered/seedvault)
"NW" = (
/obj/machinery/vending/hydroseeds,
/turf/open/floor/plasteel/dark,
/area/ruin/powered/seedvault)
"Of" = (
/obj/machinery/vending/hydronutrients,
/turf/open/floor/plasteel/dark,
/area/ruin/powered/seedvault)
"Oy" = (
/obj/item/reagent_containers/glass/bucket,
/obj/structure/table/wood,
/obj/item/reagent_containers/glass/bucket,
/obj/item/reagent_containers/glass/bucket,
/obj/item/reagent_containers/glass/bucket,
/turf/open/floor/plasteel/dark,
/area/ruin/powered/seedvault)
"OD" = (
/obj/machinery/light,
/obj/machinery/hydroponics/constructable,
/obj/effect/decal/cleanable/dirt,
/turf/open/floor/mineral/plastitanium,
/area/ruin/powered/seedvault)
"Sd" = (
/obj/structure/flora/ausbushes/sunnybush,
/obj/structure/flora/grass/jungle/b,
/area/ruin/powered/seedvault)
"Se" = (
/obj/structure/sink{
	dir = 8;
	pixel_x = 11
	},
/obj/machinery/light,
/turf/open/floor/plasteel/dark,
/area/ruin/powered/seedvault)
"Sy" = (
/obj/effect/spawner/lootdrop/seed_vault,
/obj/structure/closet/crate/hydroponics,
/obj/effect/spawner/lootdrop/seed_vault,
/obj/effect/spawner/lootdrop/seed_vault,
/obj/item/vending_refill/hydronutrients,
/obj/item/vending_refill/hydroseeds,
/turf/open/floor/vault,
/area/ruin/powered/seedvault)
"Ta" = (
/obj/machinery/atmospherics/pipe/simple/supply/hidden{
	dir = 10
	},
/turf/open/floor/plasteel/freezer,
/area/ruin/powered/seedvault)
"UA" = (
/obj/machinery/atmospherics/pipe/simple/supply/hidden,
/turf/open/floor/vault,
/area/ruin/powered/seedvault)
"UO" = (
/obj/machinery/smartfridge,
/turf/open/floor/plasteel/dark,
/area/ruin/powered/seedvault)
"UZ" = (
/turf/closed/wall/r_wall,
/area/lavaland/surface/outdoors)
"Vt" = (
/obj/machinery/light{
	dir = 8
	},
/turf/open/floor/plasteel/dark,
/area/ruin/powered/seedvault)
"Xf" = (
/obj/machinery/light{
	dir = 4
	},
/obj/machinery/hydroponics/constructable,
/obj/effect/decal/cleanable/dirt,
/obj/effect/decal/cleanable/cobweb/cobweb2,
/turf/open/floor/mineral/plastitanium,
/area/ruin/powered/seedvault)
"Xj" = (
/obj/machinery/light{
	dir = 4
	},
/obj/structure/disposalpipe/segment{
	dir = 4
	},
/obj/machinery/hydroponics/constructable,
/obj/effect/decal/cleanable/dirt,
/turf/open/floor/mineral/plastitanium,
/area/ruin/powered/seedvault)
"XP" = (
/obj/machinery/atmospherics/pipe/simple/supply/hidden{
	dir = 4
	},
/turf/open/floor/plasteel/freezer,
/area/ruin/powered/seedvault)
"Zm" = (
/turf/open/floor/mineral/titanium/blue,
/area/ruin/powered/seedvault)
"Zs" = (
/obj/structure/disposalpipe/segment{
	dir = 4
	},
/obj/effect/decal/cleanable/dirt,
/turf/open/floor/mineral/titanium/blue,
/area/ruin/powered/seedvault)
"ZT" = (
/obj/structure/table/wood,
/obj/item/stack/sheet/glass{
	amount = 10
	},
/obj/item/storage/toolbox/syndicate,
/turf/open/floor/plasteel/dark,
/area/ruin/powered/seedvault)

(1,1,1) = {"
aa
aa
aa
aa
aa
aa
aa
aa
aa
aa
aa
aa
aa
aa
aa
aa
aa
aa
ab
ab
"}
(2,1,1) = {"
aa
aa
aa
aa
ab
ab
aa
aa
aa
aa
aa
aa
ab
aa
aa
aa
aa
aa
aa
ab
"}
(3,1,1) = {"
aa
aQ
aQ
aQ
aQ
aQ
aQ
aa
aa
aa
aa
ab
ab
ab
aa
aa
aa
ab
ab
ab
"}
(4,1,1) = {"
aa
aQ
KQ
ah
aQ
hg
aQ
aQ
aQ
aQ
ab
ab
ab
ab
ab
ab
ab
ab
aa
aa
"}
(5,1,1) = {"
aa
aQ
sb
ah
ak
XP
an
Jr
xQ
lV
ab
ab
ab
ab
ab
aa
aa
aa
aa
aa
"}
(6,1,1) = {"
aa
aQ
sb
of
oz
GB
ah
Jr
IL
lV
ab
ab
aQ
aQ
aQ
aQ
aQ
aa
aa
aa
"}
(7,1,1) = {"
aa
aQ
wp
ah
aQ
XP
aP
aQ
aQ
aQ
aQ
aQ
aQ
aX
aX
aX
aQ
aQ
UZ
aa
"}
(8,1,1) = {"
aa
aQ
aQ
aQ
aQ
XP
ah
vY
aQ
CG
aQ
aB
Zm
Zm
Zm
Zm
Zm
aB
aQ
aa
"}
(9,1,1) = {"
aQ
aQ
FC
Hw
HU
XP
ah
Oy
aQ
aQ
aQ
aC
aC
Zm
Zm
Zm
Zm
Zm
aQ
aQ
"}
(10,1,1) = {"
aQ
Of
xQ
xQ
xQ
XP
ah
xQ
aw
aQ
bk
aC
Zm
ap
aH
He
Zm
Zm
OD
aQ
"}
(11,1,1) = {"
aQ
UO
xQ
of
oz
sG
oz
oz
oz
lT
oz
aE
dq
aH
mj
ll
Zm
Zm
Ay
aQ
"}
(12,1,1) = {"
aQ
NW
IL
xQ
xQ
XP
ah
xQ
Se
aQ
BK
aC
Zm
gs
sR
lk
Zm
Zm
OD
aQ
"}
(13,1,1) = {"
aQ
aQ
aQ
ai
xQ
XP
ah
eL
aQ
aQ
aQ
Zm
Zm
Zm
sd
Zm
Zm
Zm
aQ
aQ
"}
(14,1,1) = {"
aQ
ZT
Vt
xQ
xQ
XP
ah
ah
ay
ni
aQ
aB
Zm
aC
Zs
Zm
aC
aB
aQ
aa
"}
(15,1,1) = {"
aQ
uE
xQ
of
oz
GB
ah
eL
aQ
ni
aQ
aQ
aQ
Xf
Xj
kZ
aQ
aQ
aQ
aa
"}
(16,1,1) = {"
aQ
bs
xQ
xQ
xQ
aj
aQ
aQ
aQ
xG
ni
po
aQ
AK
rk
aQ
aQ
ab
ab
aa
"}
(17,1,1) = {"
aQ
aQ
HV
xQ
xQ
XP
aQ
jC
BJ
ni
ni
po
aQ
mz
Sd
pM
ab
ab
aa
aa
"}
(18,1,1) = {"
aa
aQ
aQ
sx
sx
Ta
eg
UA
UA
yU
po
aQ
aQ
ad
mg
aK
lz
ab
ab
ab
"}
(19,1,1) = {"
aa
aa
aQ
sx
zY
ah
aQ
Sy
Sy
Sy
aQ
aQ
aa
aa
aa
aa
ab
ab
ab
ab
"}
(20,1,1) = {"
aa
aa
aQ
aQ
aQ
aQ
aQ
aQ
aQ
aQ
aQ
aa
aa
aa
aa
aa
aa
ab
ab
aa
"}
