//MAP CONVERTED BY dmm2tgm.py THIS HEADER COMMENT PREVENTS RECONVERSION, DO NOT REMOVE
"a" = (
/turf/open/floor/plating,
/area/space)
"q" = (
/obj/machinery/power/port_gen/pacman/super,
/turf/open/floor/plating,
/area/space)

(1,1,1) = {"
a
a
a
"}
(2,1,1) = {"
a
q
a
"}
(3,1,1) = {"
a
a
a
"}
