//MAP CONVERTED BY dmm2tgm.py THIS HEADER COMMENT PREVENTS RECONVERSION, DO NOT REMOVE
"ad" = (
/obj/machinery/atmospherics/pipe/simple/orange/visible,
/obj/effect/turf_decal/arrows/red{
	pixel_x = -5
	},
/obj/machinery/meter,
/turf/open/floor/engine,
/area/engine/engineering)
"ak" = (
/obj/machinery/atmospherics/pipe/heat_exchanging/simple,
/obj/machinery/atmospherics/pipe/simple/scrubbers/visible{
	dir = 4
	},
/turf/open/floor/engine,
/area/engine/engineering)
"bd" = (
/obj/effect/turf_decal/stripes/line{
	dir = 4
	},
/obj/machinery/light{
	dir = 4
	},
/turf/open/floor/engine,
/area/engine/engineering)
"cw" = (
/obj/effect/turf_decal/stripes/line{
	dir = 1
	},
/obj/structure/cable/layer1,
/obj/machinery/atmospherics/components/binary/pump/on{
	dir = 1
	},
/obj/structure/cable,
/turf/open/floor/engine,
/area/engine/engineering)
"cR" = (
/obj/machinery/atmospherics/pipe/simple/purple/visible,
/turf/open/floor/engine,
/area/engine/engineering)
"dd" = (
/obj/machinery/atmospherics/pipe/simple/orange/visible,
/obj/effect/turf_decal/arrows/red{
	pixel_x = -5
	},
/obj/effect/turf_decal/stripes/line{
	dir = 8
	},
/obj/machinery/light{
	dir = 8
	},
/turf/open/floor/engine,
/area/engine/engineering)
"dv" = (
/obj/machinery/atmospherics/pipe/simple/orange/visible,
/obj/effect/turf_decal/arrows/red{
	dir = 1;
	pixel_x = -5
	},
/turf/open/floor/engine,
/area/engine/engineering)
"ep" = (
/obj/machinery/atmospherics/pipe/simple/cyan/visible{
	dir = 4
	},
/obj/machinery/atmospherics/pipe/simple/orange/visible,
/turf/open/floor/engine,
/area/engine/engineering)
"fV" = (
/obj/machinery/atmospherics/pipe/simple/cyan/visible{
	dir = 4
	},
/obj/effect/turf_decal/arrows/white{
	dir = 4;
	pixel_y = -5
	},
/turf/open/floor/engine,
/area/engine/engineering)
"gn" = (
/obj/machinery/atmospherics/pipe/simple/cyan/visible{
	dir = 9
	},
/turf/open/floor/engine,
/area/engine/engineering)
"gt" = (
/obj/machinery/atmospherics/pipe/simple/scrubbers/hidden{
	dir = 4
	},
/turf/closed/wall/r_wall,
/area/engine/engineering)
"gF" = (
/obj/machinery/atmospherics/pipe/simple/cyan/visible,
/turf/open/floor/engine,
/area/engine/engineering)
"hd" = (
/obj/effect/turf_decal/stripes/line{
	dir = 8
	},
/turf/open/floor/engine,
/area/engine/engineering)
"hq" = (
/obj/effect/turf_decal/stripes/line{
	dir = 8
	},
/obj/machinery/atmospherics/components/binary/pump{
	dir = 1
	},
/turf/open/floor/engine,
/area/engine/engineering)
"hx" = (
/obj/structure/cable/multilayer{
	cable_layer = 1
	},
/obj/machinery/power/terminal{
	dir = 4;
	icon_state = "term"
	},
/obj/effect/turf_decal/stripes/line{
	dir = 5
	},
/obj/machinery/light{
	dir = 1
	},
/turf/open/floor/engine,
/area/engine/engineering)
"hW" = (
/obj/effect/turf_decal/stripes/line,
/obj/machinery/atmospherics/pipe/simple/purple/visible{
	dir = 5
	},
/turf/open/floor/engine,
/area/engine/engineering)
"iI" = (
/obj/effect/turf_decal/stripes/line{
	dir = 8
	},
/obj/machinery/atmospherics/components/binary/pump/on{
	dir = 8
	},
/turf/open/floor/engine,
/area/engine/engineering)
"ju" = (
/obj/effect/turf_decal/stripes/line{
	dir = 8
	},
/obj/machinery/atmospherics/components/binary/pump{
	dir = 4
	},
/turf/open/floor/engine,
/area/engine/engineering)
"jM" = (
/obj/effect/spawner/structure/window/plasma/reinforced,
/obj/machinery/door/poddoor/shutters/preopen{
	id = "burnchamb"
	},
/turf/open/floor/plating,
/area/engine/engineering)
"kr" = (
/obj/effect/turf_decal/stripes/line{
	dir = 8
	},
/obj/machinery/atmospherics/pipe/simple/purple/visible{
	dir = 5
	},
/turf/open/floor/engine,
/area/engine/engineering)
"kO" = (
/obj/machinery/atmospherics/pipe/simple/orange/visible,
/obj/effect/turf_decal/arrows/red{
	pixel_x = -5
	},
/turf/open/floor/engine,
/area/engine/engineering)
"lK" = (
/turf/open/floor/engine,
/area/engine/engineering)
"mM" = (
/obj/structure/lattice,
/turf/open/space/basic,
/area/space/nearstation)
"nW" = (
/obj/machinery/atmospherics/pipe/heat_exchanging/simple{
	dir = 5
	},
/turf/open/floor/engine,
/area/engine/engineering)
"om" = (
/obj/machinery/atmospherics/pipe/simple/cyan/visible{
	dir = 5
	},
/turf/open/floor/engine,
/area/engine/engineering)
"oF" = (
/obj/effect/spawner/structure/window/plasma/reinforced,
/obj/machinery/door/poddoor/shutters/preopen{
	id = "burnchamb"
	},
/obj/machinery/atmospherics/pipe/simple/scrubbers/hidden{
	dir = 4
	},
/turf/open/floor/plating,
/area/engine/engineering)
"oK" = (
/obj/structure/cable/layer1,
/obj/machinery/atmospherics/components/binary/pump,
/turf/open/floor/engine,
/area/engine/engineering)
"pz" = (
/obj/machinery/atmospherics/components/unary/vent_scrubber/on{
	dir = 4
	},
/turf/open/floor/engine,
/area/engine/engineering)
"pN" = (
/obj/machinery/atmospherics/pipe/simple/cyan/visible{
	dir = 10
	},
/obj/machinery/meter,
/turf/open/floor/engine,
/area/engine/engineering)
"qx" = (
/obj/effect/turf_decal/stripes/line{
	dir = 4
	},
/obj/machinery/atmospherics/pipe/simple/scrubbers/visible{
	dir = 6
	},
/turf/open/floor/engine,
/area/engine/engineering)
"qD" = (
/obj/machinery/atmospherics/pipe/manifold/purple/visible{
	dir = 4
	},
/turf/open/floor/engine,
/area/engine/engineering)
"qF" = (
/obj/effect/turf_decal/arrows/red{
	pixel_x = -5
	},
/obj/machinery/atmospherics/pipe/manifold/orange/visible{
	dir = 8
	},
/turf/open/floor/engine,
/area/engine/engineering)
"qG" = (
/obj/machinery/meter,
/obj/machinery/atmospherics/pipe/manifold/orange/visible{
	dir = 1
	},
/turf/open/floor/engine,
/area/engine/engineering)
"ra" = (
/obj/machinery/door/poddoor{
	id = "burnrelease"
	},
/turf/open/floor/plating,
/area/engine/engineering)
"rZ" = (
/obj/machinery/atmospherics/pipe/simple/orange/visible{
	dir = 5
	},
/turf/open/floor/engine,
/area/engine/engineering)
"se" = (
/obj/machinery/atmospherics/components/binary/pump{
	dir = 4
	},
/turf/open/floor/engine,
/area/engine/engineering)
"sK" = (
/obj/effect/turf_decal/stripes/line{
	dir = 1
	},
/obj/machinery/atmospherics/components/binary/pump/on,
/obj/structure/cable,
/turf/open/floor/engine,
/area/engine/engineering)
"sN" = (
/obj/effect/turf_decal/stripes/line{
	dir = 1
	},
/obj/machinery/light{
	dir = 1
	},
/obj/structure/cable,
/turf/open/floor/engine,
/area/engine/engineering)
"sU" = (
/obj/effect/spawner/structure/window/plasma/reinforced,
/obj/machinery/atmospherics/pipe/simple/scrubbers/visible{
	dir = 4
	},
/turf/open/floor/plating,
/area/engine/engineering)
"tb" = (
/obj/machinery/atmospherics/pipe/simple/orange/visible,
/obj/effect/turf_decal/arrows/red{
	dir = 1;
	pixel_x = -5
	},
/obj/machinery/meter,
/turf/open/floor/engine,
/area/engine/engineering)
"tT" = (
/obj/machinery/atmospherics/pipe/simple/cyan/visible{
	dir = 10
	},
/turf/open/floor/engine,
/area/engine/engineering)
"ur" = (
/obj/machinery/atmospherics/pipe/simple/cyan/visible{
	dir = 4
	},
/obj/effect/turf_decal/arrows/white{
	dir = 8;
	icon_state = "arrows_white";
	pixel_y = -5
	},
/obj/machinery/atmospherics/pipe/simple/purple/visible,
/turf/open/floor/engine,
/area/engine/engineering)
"uK" = (
/turf/closed/wall/r_wall,
/area/engine/engineering)
"vU" = (
/obj/machinery/atmospherics/pipe/simple/cyan/visible{
	dir = 4
	},
/obj/machinery/atmospherics/pipe/simple/orange/visible,
/obj/effect/turf_decal/arrows/red{
	dir = 1;
	pixel_x = -5
	},
/turf/open/floor/engine,
/area/engine/engineering)
"wf" = (
/obj/effect/turf_decal/stripes/line{
	dir = 6
	},
/obj/machinery/atmospherics/components/unary/portables_connector/visible{
	dir = 8
	},
/turf/open/floor/engine,
/area/engine/engineering)
"xH" = (
/obj/machinery/atmospherics/pipe/simple/purple/visible{
	dir = 10;
	icon_state = "pipe11-2"
	},
/turf/open/floor/engine,
/area/engine/engineering)
"yb" = (
/obj/effect/spawner/structure/window/plasma/reinforced,
/obj/machinery/door/poddoor/shutters/preopen{
	id = "burnchamb"
	},
/obj/machinery/atmospherics/pipe/heat_exchanging/junction,
/turf/open/floor/plating,
/area/engine/engineering)
"yg" = (
/obj/machinery/atmospherics/pipe/simple/orange/visible{
	dir = 10
	},
/turf/open/floor/engine,
/area/engine/engineering)
"zp" = (
/obj/structure/cable/layer1,
/obj/machinery/atmospherics/pipe/simple/orange/visible{
	dir = 9
	},
/obj/structure/cable,
/turf/open/floor/engine,
/area/engine/engineering)
"zA" = (
/obj/machinery/atmospherics/pipe/simple/purple/visible{
	dir = 5
	},
/obj/machinery/meter,
/turf/open/floor/engine,
/area/engine/engineering)
"zB" = (
/obj/machinery/button/door{
	id = "burnrelease";
	name = "Burn Chamber Release Shutters Control";
	pixel_y = -24;
	req_access_txt = "10"
	},
/obj/effect/turf_decal/stripes/line,
/turf/open/floor/engine,
/area/engine/engineering)
"As" = (
/obj/structure/cable/multilayer{
	cable_layer = 3
	},
/turf/open/floor/engine,
/area/engine/engineering)
"Av" = (
/obj/machinery/atmospherics/pipe/simple/orange/visible{
	dir = 4
	},
/turf/open/floor/engine,
/area/engine/engineering)
"BJ" = (
/obj/effect/turf_decal/stripes/line{
	dir = 1
	},
/obj/structure/cable,
/turf/open/floor/engine,
/area/engine/engineering)
"Cb" = (
/obj/effect/turf_decal/stripes/line{
	dir = 4
	},
/turf/open/floor/engine,
/area/engine/engineering)
"CA" = (
/obj/effect/turf_decal/arrows/red{
	dir = 1;
	icon_state = "arrows_red";
	pixel_x = -5
	},
/obj/machinery/atmospherics/pipe/manifold/orange/visible{
	dir = 4
	},
/turf/open/floor/engine,
/area/engine/engineering)
"CK" = (
/obj/machinery/atmospherics/pipe/manifold/purple/visible{
	dir = 1
	},
/turf/open/floor/engine,
/area/engine/engineering)
"CZ" = (
/obj/structure/cable/multilayer{
	cable_layer = 1
	},
/obj/machinery/power/terminal{
	dir = 4;
	icon_state = "term"
	},
/obj/effect/turf_decal/stripes/line{
	dir = 4
	},
/turf/open/floor/engine,
/area/engine/engineering)
"DH" = (
/obj/effect/turf_decal/arrows/white{
	dir = 8;
	icon_state = "arrows_white";
	pixel_y = -5
	},
/obj/machinery/atmospherics/pipe/manifold/cyan/visible,
/turf/open/floor/engine,
/area/engine/engineering)
"DO" = (
/obj/machinery/atmospherics/pipe/manifold/cyan/visible{
	dir = 4
	},
/obj/machinery/meter,
/turf/open/floor/engine,
/area/engine/engineering)
"Ee" = (
/obj/machinery/atmospherics/pipe/simple/orange/visible{
	dir = 9
	},
/turf/open/floor/engine,
/area/engine/engineering)
"EL" = (
/obj/machinery/atmospherics/pipe/manifold/orange/visible{
	dir = 8
	},
/turf/open/floor/engine,
/area/engine/engineering)
"Fj" = (
/obj/effect/turf_decal/stripes/line{
	dir = 6
	},
/obj/machinery/light,
/turf/open/floor/engine,
/area/engine/engineering)
"FF" = (
/obj/machinery/atmospherics/pipe/heat_exchanging/simple{
	dir = 9
	},
/turf/open/floor/engine,
/area/engine/engineering)
"Gs" = (
/obj/machinery/atmospherics/pipe/simple/cyan/visible{
	dir = 4
	},
/obj/effect/turf_decal/arrows/white{
	dir = 8;
	icon_state = "arrows_white";
	pixel_y = -5
	},
/turf/open/floor/engine,
/area/engine/engineering)
"GL" = (
/obj/machinery/atmospherics/pipe/simple/purple/visible{
	dir = 4
	},
/turf/open/floor/engine,
/area/engine/engineering)
"GQ" = (
/obj/machinery/power/generator{
	dir = 8
	},
/obj/structure/cable,
/turf/open/floor/engine,
/area/engine/engineering)
"Hl" = (
/obj/effect/spawner/structure/window/plasma/reinforced,
/turf/open/floor/plating,
/area/engine/engineering)
"Hr" = (
/obj/effect/turf_decal/stripes/line{
	dir = 10
	},
/obj/machinery/atmospherics/components/binary/pump/on{
	dir = 4
	},
/obj/machinery/light,
/turf/open/floor/engine,
/area/engine/engineering)
"Ii" = (
/obj/machinery/atmospherics/pipe/heat_exchanging/simple,
/turf/open/floor/engine,
/area/engine/engineering)
"In" = (
/obj/effect/turf_decal/stripes/line{
	dir = 4
	},
/obj/machinery/atmospherics/components/unary/portables_connector/visible{
	dir = 8
	},
/turf/open/floor/engine,
/area/engine/engineering)
"IM" = (
/obj/machinery/igniter{
	id = "burnigniter";
	luminosity = 2
	},
/obj/machinery/atmospherics/pipe/heat_exchanging/simple{
	dir = 4
	},
/turf/open/floor/engine,
/area/engine/engineering)
"JB" = (
/obj/effect/turf_decal/stripes/end,
/turf/open/floor/engine,
/area/engine/engineering)
"JK" = (
/obj/machinery/atmospherics/pipe/heat_exchanging/simple{
	dir = 6
	},
/turf/open/floor/engine,
/area/engine/engineering)
"KZ" = (
/obj/machinery/atmospherics/pipe/simple/orange/visible{
	dir = 6
	},
/turf/open/floor/engine,
/area/engine/engineering)
"ML" = (
/obj/machinery/atmospherics/pipe/simple/orange/visible,
/obj/effect/turf_decal/arrows/red{
	dir = 1;
	pixel_x = -5
	},
/obj/effect/turf_decal/stripes/line,
/obj/machinery/meter,
/turf/open/floor/engine,
/area/engine/engineering)
"MQ" = (
/obj/effect/turf_decal/stripes/line{
	dir = 4
	},
/obj/structure/cable,
/turf/open/floor/engine,
/area/engine/engineering)
"Nx" = (
/obj/machinery/atmospherics/components/binary/circulator/cold{
	dir = 1
	},
/turf/open/floor/engine,
/area/engine/engineering)
"Oa" = (
/obj/machinery/atmospherics/components/unary/portables_connector/visible,
/obj/effect/turf_decal/stripes/box,
/obj/machinery/portable_atmospherics/canister/toxins,
/turf/open/floor/engine,
/area/engine/engineering)
"Of" = (
/obj/structure/cable/layer1,
/turf/open/floor/engine,
/area/engine/engineering)
"Oi" = (
/obj/machinery/atmospherics/components/binary/pump{
	dir = 1
	},
/turf/open/floor/engine,
/area/engine/engineering)
"PA" = (
/obj/effect/turf_decal/stripes/line{
	dir = 4
	},
/obj/machinery/atmospherics/components/binary/pump{
	dir = 4
	},
/turf/open/floor/engine,
/area/engine/engineering)
"PH" = (
/obj/machinery/atmospherics/pipe/simple/orange/visible,
/turf/open/floor/engine,
/area/engine/engineering)
"QB" = (
/obj/machinery/atmospherics/pipe/heat_exchanging/simple,
/obj/machinery/atmospherics/pipe/simple/purple/visible{
	dir = 4
	},
/turf/open/floor/engine,
/area/engine/engineering)
"QD" = (
/obj/effect/turf_decal/stripes/line,
/turf/open/floor/engine,
/area/engine/engineering)
"QH" = (
/obj/machinery/atmospherics/pipe/simple/cyan/visible{
	dir = 4
	},
/obj/machinery/meter,
/turf/open/floor/engine,
/area/engine/engineering)
"QI" = (
/obj/machinery/atmospherics/pipe/simple/cyan/visible{
	dir = 4
	},
/obj/effect/turf_decal/arrows/white{
	dir = 4;
	pixel_y = -5
	},
/obj/machinery/atmospherics/pipe/simple/purple/visible,
/turf/open/floor/engine,
/area/engine/engineering)
"QS" = (
/obj/machinery/button/door{
	id = "burnchamb";
	name = "Burn Chamber Shutters Control";
	pixel_x = 6;
	pixel_y = -26;
	req_access_txt = "10"
	},
/obj/machinery/button/ignition{
	id = "burnigniter";
	pixel_x = -6;
	pixel_y = -26
	},
/obj/effect/turf_decal/stripes/line,
/obj/machinery/light,
/turf/open/floor/engine,
/area/engine/engineering)
"RB" = (
/obj/machinery/atmospherics/components/binary/pump{
	dir = 8
	},
/turf/open/floor/engine,
/area/engine/engineering)
"RF" = (
/obj/effect/spawner/structure/window/plasma/reinforced,
/obj/machinery/door/poddoor/shutters/preopen{
	id = "burnchamb"
	},
/obj/machinery/atmospherics/pipe/simple/purple/visible{
	dir = 4
	},
/turf/open/floor/plating,
/area/engine/engineering)
"RP" = (
/obj/effect/turf_decal/stripes/line{
	dir = 4
	},
/obj/machinery/atmospherics/pipe/simple/scrubbers/visible,
/turf/open/floor/engine,
/area/engine/engineering)
"Sp" = (
/obj/effect/turf_decal/stripes/line{
	dir = 9
	},
/obj/machinery/light{
	dir = 1
	},
/turf/open/floor/engine,
/area/engine/engineering)
"Ss" = (
/obj/effect/turf_decal/stripes/line{
	dir = 8
	},
/obj/machinery/atmospherics/pipe/simple/purple/visible{
	dir = 6
	},
/turf/open/floor/engine,
/area/engine/engineering)
"SH" = (
/obj/machinery/atmospherics/components/binary/circulator,
/turf/open/floor/engine,
/area/engine/engineering)
"SO" = (
/obj/effect/spawner/structure/window/plasma/reinforced,
/obj/machinery/door/poddoor/shutters/preopen{
	id = "burnchamb"
	},
/obj/machinery/atmospherics/pipe/heat_exchanging/junction{
	dir = 8
	},
/turf/open/floor/plating,
/area/engine/engineering)
"Uc" = (
/obj/effect/turf_decal/stripes/line{
	dir = 4
	},
/obj/machinery/atmospherics/pipe/simple/scrubbers/visible{
	dir = 9
	},
/obj/effect/turf_decal/stripes/line{
	dir = 8
	},
/turf/open/floor/engine,
/area/engine/engineering)
"Ux" = (
/obj/machinery/atmospherics/pipe/simple/orange/visible,
/obj/effect/turf_decal/arrows/red{
	dir = 1;
	icon_state = "arrows_red";
	pixel_x = -5
	},
/turf/open/floor/engine,
/area/engine/engineering)
"UK" = (
/obj/machinery/atmospherics/pipe/simple/orange/visible{
	dir = 9
	},
/obj/effect/turf_decal/stripes/line{
	dir = 10
	},
/obj/machinery/meter,
/turf/open/floor/engine,
/area/engine/engineering)
"Vw" = (
/obj/machinery/atmospherics/pipe/simple/cyan/visible{
	dir = 4
	},
/turf/open/floor/engine,
/area/engine/engineering)
"VD" = (
/obj/machinery/airalarm/all_access{
	dir = 1;
	pixel_y = -24
	},
/obj/effect/turf_decal/stripes/line,
/obj/machinery/light,
/turf/open/floor/engine,
/area/engine/engineering)
"VU" = (
/obj/machinery/atmospherics/pipe/manifold/orange/visible{
	dir = 4
	},
/turf/open/floor/engine,
/area/engine/engineering)
"Wc" = (
/obj/structure/cable/layer1,
/obj/structure/cable,
/turf/open/floor/engine,
/area/engine/engineering)
"WG" = (
/obj/machinery/atmospherics/components/unary/portables_connector/visible{
	dir = 4
	},
/obj/machinery/portable_atmospherics/canister/nitrogen,
/obj/effect/turf_decal/stripes/box,
/turf/open/floor/engine,
/area/engine/engineering)
"XB" = (
/obj/effect/turf_decal/stripes/line{
	dir = 10
	},
/turf/open/floor/engine,
/area/engine/engineering)
"XT" = (
/obj/machinery/atmospherics/components/unary/outlet_injector/on{
	dir = 8
	},
/turf/open/floor/engine,
/area/engine/engineering)
"ZF" = (
/obj/machinery/atmospherics/components/binary/pump{
	layer = 2.4
	},
/turf/open/floor/engine,
/area/engine/engineering)

(1,1,1) = {"
Sp
hd
hd
hd
hd
ju
hd
iI
hd
hd
Hr
uK
Hl
Hl
uK
uK
"}
(2,1,1) = {"
BJ
lK
lK
lK
lK
GL
lK
pN
om
lK
QH
hd
Ss
hq
kr
XB
"}
(3,1,1) = {"
BJ
lK
WG
WG
lK
xH
cR
cR
ur
cR
QI
cR
qD
zA
CK
hW
"}
(4,1,1) = {"
BJ
lK
qG
Ee
lK
Oa
om
lK
Gs
lK
fV
lK
bd
PA
In
wf
"}
(5,1,1) = {"
BJ
lK
se
lK
lK
Oa
DO
ZF
DH
lK
fV
VD
uK
RF
jM
jM
"}
(6,1,1) = {"
BJ
KZ
VU
qF
kO
ad
EL
Oi
ep
dv
vU
ML
yb
QB
Ii
nW
"}
(7,1,1) = {"
sN
Av
lK
Av
lK
lK
SH
GQ
Nx
lK
Vw
QD
jM
XT
pz
IM
"}
(8,1,1) = {"
sK
Ee
lK
RB
lK
lK
Av
As
tT
gF
gn
QD
jM
JK
ak
FF
"}
(9,1,1) = {"
BJ
KZ
PH
CA
Ux
tb
VU
oK
PH
rZ
lK
QS
uK
SO
gt
ra
"}
(10,1,1) = {"
BJ
Av
lK
lK
lK
lK
lK
Of
lK
yg
kO
kO
dd
UK
oF
mM
"}
(11,1,1) = {"
BJ
Av
lK
lK
lK
lK
lK
Of
lK
lK
lK
lK
lK
zB
gt
uK
"}
(12,1,1) = {"
cw
zp
Wc
Wc
Wc
Of
Of
Of
lK
lK
lK
Cb
qx
RP
Uc
JB
"}
(13,1,1) = {"
hx
CZ
MQ
CZ
MQ
Cb
Cb
Cb
Cb
Cb
Fj
uK
sU
Hl
uK
uK
"}
