//MAP CONVERTED BY dmm2tgm.py THIS HEADER COMMENT PREVENTS RECONVERSION, DO NOT REMOVE
"at" = (
/obj/structure/cable,
/turf/open/floor/plating,
/area/space/nearstation)
"aA" = (
/obj/structure/cable,
/turf/open/floor/plasteel/techmaint,
/area/engine/engineering)
"bq" = (
/obj/structure/lattice/catwalk,
/obj/item/stack/marker_beacon{
	anchored = 1;
	icon_state = "markerburgundy-on";
	light_color = "#FA644B";
	light_power = 3;
	light_range = 2;
	name = "landing marker";
	picked_color = "Burgundy"
	},
/turf/open/space/basic,
/area/space/nearstation)
"ch" = (
/obj/structure/cable/multilayer{
	cable_layer = 1
	},
/obj/machinery/power/terminal{
	dir = 4;
	icon_state = "term"
	},
/turf/open/floor/plasteel/techmaint,
/area/engine/engineering)
"dU" = (
/obj/machinery/power/rad_collector/anchored,
/obj/structure/cable,
/turf/open/floor/plating/airless,
/area/space/nearstation)
"ed" = (
/obj/machinery/atmospherics/pipe/simple/supply/hidden,
/turf/open/floor/plasteel/techmaint,
/area/engine/engineering)
"eV" = (
/obj/structure/cable,
/turf/open/floor/plasteel/tech/grid,
/area/engine/engineering)
"fb" = (
/turf/open/floor/plasteel/techmaint,
/area/engine/engineering)
"go" = (
/obj/machinery/light{
	dir = 8
	},
/turf/open/floor/plating/airless,
/area/space/nearstation)
"ht" = (
/obj/structure/cable,
/obj/effect/turf_decal/stripes/line{
	dir = 1
	},
/obj/machinery/atmospherics/components/binary/dp_vent_pump{
	dir = 4
	},
/obj/machinery/advanced_airlock_controller{
	pixel_x = -30;
	pixel_y = 30
	},
/obj/structure/cable/layer1,
/turf/open/floor/plating,
/area/engine/engineering)
"iz" = (
/turf/open/floor/plasteel/tech/grid,
/area/engine/engineering)
"iJ" = (
/obj/machinery/atmospherics/components/unary/vent_scrubber/on/layer1{
	dir = 4;
	icon_state = "scrub_map_on-1"
	},
/turf/open/floor/plasteel/techmaint,
/area/engine/engineering)
"iL" = (
/obj/machinery/camera{
	c_tag = "Engineering Singularity";
	dir = 6;
	network = list("ss13","engine");
	upgrades = 2
	},
/turf/open/floor/plasteel/tech/grid,
/area/engine/engineering)
"jV" = (
/obj/structure/lattice/catwalk,
/obj/structure/cable,
/turf/open/space/basic,
/area/space/nearstation)
"kO" = (
/obj/structure/lattice/catwalk,
/obj/structure/cable/multilayer{
	cable_layer = 3
	},
/turf/open/space/basic,
/area/space/nearstation)
"kQ" = (
/obj/structure/cable,
/obj/machinery/door/airlock/external{
	req_access_txt = "10; 13"
	},
/obj/effect/mapping_helpers/airlock/cyclelink_helper{
	dir = 1
	},
/obj/machinery/door/poddoor/shutters/preopen{
	id = "engsing";
	name = "Singularity Access"
	},
/obj/structure/cable/layer1,
/turf/open/floor/plating,
/area/engine/engineering)
"kU" = (
/obj/machinery/atmospherics/components/unary/vent_pump/on{
	dir = 1
	},
/turf/open/floor/plasteel/techmaint,
/area/engine/engineering)
"lw" = (
/obj/machinery/atmospherics/pipe/manifold/supply/hidden{
	dir = 8
	},
/turf/open/floor/plasteel/techmaint,
/area/engine/engineering)
"ly" = (
/obj/structure/lattice/catwalk,
/turf/open/space,
/area/space/nearstation)
"lR" = (
/obj/machinery/atmospherics/pipe/simple/supply/hidden{
	dir = 4
	},
/obj/machinery/light{
	dir = 8
	},
/obj/structure/closet/emcloset{
	anchored = 1
	},
/turf/open/floor/plating/airless,
/area/engine/engineering)
"mr" = (
/obj/structure/cable,
/obj/effect/turf_decal/stripes/line{
	dir = 1
	},
/obj/machinery/atmospherics/components/binary/dp_vent_pump{
	dir = 4
	},
/obj/machinery/advanced_airlock_controller{
	pixel_x = 30;
	pixel_y = 30
	},
/obj/structure/cable/layer1,
/turf/open/floor/plating,
/area/engine/engineering)
"mu" = (
/obj/structure/sign/warning/vacuum/external,
/obj/machinery/atmospherics/pipe/simple/scrubbers/hidden{
	dir = 6
	},
/turf/closed/wall,
/area/engine/engineering)
"mx" = (
/obj/machinery/button/door{
	id = "engsing";
	name = "Singularity Access";
	pixel_y = -24;
	req_access_txt = "10"
	},
/obj/machinery/atmospherics/pipe/simple/supply/hidden{
	dir = 4
	},
/turf/open/floor/plasteel/techmaint,
/area/engine/engineering)
"mU" = (
/obj/structure/cable,
/obj/effect/turf_decal/stripes/line{
	dir = 8
	},
/turf/open/floor/monotile/dark,
/area/engine/engineering)
"nO" = (
/obj/structure/particle_accelerator/fuel_chamber,
/turf/open/floor/monotile/dark,
/area/engine/engineering)
"od" = (
/obj/machinery/atmospherics/pipe/simple/scrubbers/visible{
	dir = 4
	},
/obj/machinery/light{
	dir = 4
	},
/obj/structure/closet/emcloset{
	anchored = 1
	},
/turf/open/floor/plating/airless,
/area/engine/engineering)
"pe" = (
/obj/effect/turf_decal/stripes/line{
	dir = 1
	},
/obj/effect/turf_decal/stripes/line,
/turf/open/floor/plating,
/area/space/nearstation)
"pH" = (
/obj/structure/particle_accelerator/end_cap,
/obj/effect/turf_decal/stripes/line{
	dir = 1
	},
/turf/open/floor/monotile/dark,
/area/engine/engineering)
"pJ" = (
/obj/effect/turf_decal/stripes/line{
	dir = 4
	},
/obj/machinery/atmospherics/pipe/simple/scrubbers/hidden/layer1{
	dir = 5;
	icon_state = "pipe11-1"
	},
/turf/open/floor/plasteel/techmaint,
/area/engine/engineering)
"sh" = (
/obj/machinery/light{
	dir = 1
	},
/turf/open/floor/plasteel/tech/grid,
/area/engine/engineering)
"sZ" = (
/obj/structure/cable/layer1,
/obj/structure/cable,
/obj/machinery/atmospherics/pipe/layer_manifold,
/turf/open/floor/plasteel/techmaint,
/area/engine/engineering)
"tA" = (
/obj/structure/cable/layer1,
/obj/structure/cable,
/obj/machinery/atmospherics/pipe/simple/supply/hidden{
	dir = 4
	},
/turf/open/floor/plasteel/tech/grid,
/area/engine/engineering)
"un" = (
/obj/effect/turf_decal/stripes/box,
/obj/machinery/field/generator,
/obj/structure/cable/layer1,
/obj/structure/cable,
/turf/open/floor/plating,
/area/space/nearstation)
"uv" = (
/obj/machinery/atmospherics/pipe/simple/scrubbers/hidden{
	dir = 4
	},
/turf/closed/wall/r_wall,
/area/engine/engineering)
"uO" = (
/obj/machinery/the_singularitygen,
/turf/open/floor/plating,
/area/space/nearstation)
"vj" = (
/obj/effect/spawner/structure/window/plasma/reinforced,
/obj/machinery/door/poddoor/shutters/preopen{
	id = "engsing";
	name = "Singularity Access"
	},
/obj/machinery/door/firedoor/window,
/obj/machinery/atmospherics/pipe/simple/scrubbers/hidden{
	dir = 9
	},
/turf/open/floor/plating,
/area/engine/engineering)
"ww" = (
/obj/structure/cable/layer1,
/obj/structure/cable,
/obj/structure/lattice/catwalk,
/turf/open/floor/plating/airless,
/area/space/nearstation)
"wx" = (
/turf/open/space/basic,
/area/space)
"xe" = (
/obj/effect/turf_decal/stripes/line{
	dir = 4
	},
/turf/open/floor/monotile/dark,
/area/engine/engineering)
"xf" = (
/obj/structure/particle_accelerator/particle_emitter/center,
/obj/effect/turf_decal/stripes/line,
/turf/open/floor/monotile/dark,
/area/engine/engineering)
"xE" = (
/obj/machinery/light{
	dir = 4
	},
/turf/open/floor/plating/airless,
/area/space/nearstation)
"By" = (
/obj/structure/sign/warning/vacuum/external,
/obj/machinery/atmospherics/pipe/simple/scrubbers/hidden{
	dir = 4
	},
/obj/machinery/atmospherics/pipe/simple/supply/hidden,
/turf/closed/wall,
/area/engine/engineering)
"BY" = (
/obj/structure/cable/layer1,
/obj/structure/cable,
/turf/open/floor/plasteel/tech/grid,
/area/engine/engineering)
"CS" = (
/obj/machinery/particle_accelerator/control_box,
/obj/structure/cable,
/obj/effect/turf_decal/stripes/line{
	dir = 8
	},
/turf/open/floor/monotile/dark,
/area/engine/engineering)
"Do" = (
/obj/machinery/atmospherics/pipe/simple/scrubbers/hidden/layer1{
	dir = 5;
	icon_state = "pipe11-1"
	},
/obj/machinery/atmospherics/pipe/manifold/scrubbers/hidden{
	dir = 4
	},
/turf/open/floor/plasteel/techmaint,
/area/engine/engineering)
"Dv" = (
/obj/structure/cable/layer1,
/obj/structure/cable,
/obj/machinery/light,
/obj/machinery/atmospherics/pipe/simple/supply/hidden{
	dir = 10
	},
/turf/open/floor/plasteel/tech/grid,
/area/engine/engineering)
"Fk" = (
/obj/effect/turf_decal/stripes/box,
/obj/machinery/field/generator,
/obj/structure/cable,
/turf/open/floor/plating/airless,
/area/space/nearstation)
"Ft" = (
/obj/structure/lattice/catwalk,
/obj/structure/cable/layer1,
/obj/structure/cable,
/turf/open/space/basic,
/area/space/nearstation)
"GY" = (
/obj/effect/turf_decal/stripes/line{
	dir = 1
	},
/obj/effect/turf_decal/stripes/line,
/turf/open/floor/plating/airless,
/area/space/nearstation)
"Hq" = (
/obj/structure/cable/layer1,
/obj/structure/cable,
/obj/machinery/atmospherics/pipe/simple/scrubbers/hidden/layer1{
	dir = 10;
	icon_state = "pipe11-1"
	},
/turf/open/floor/plasteel/techmaint,
/area/engine/engineering)
"Hv" = (
/turf/open/floor/plating/airless,
/area/space/nearstation)
"HE" = (
/obj/structure/sign/warning/radiation,
/obj/machinery/atmospherics/pipe/simple/scrubbers/hidden{
	dir = 9
	},
/turf/closed/wall,
/area/engine/engineering)
"Ir" = (
/obj/machinery/atmospherics/pipe/simple/supply/hidden{
	dir = 6
	},
/turf/open/floor/plasteel/techmaint,
/area/engine/engineering)
"JN" = (
/obj/structure/particle_accelerator/particle_emitter/left,
/obj/structure/cable,
/obj/effect/turf_decal/stripes/line{
	dir = 10
	},
/turf/open/floor/monotile/dark,
/area/engine/engineering)
"Li" = (
/obj/structure/cable/layer1,
/obj/structure/cable,
/obj/machinery/light,
/obj/machinery/atmospherics/pipe/simple/supply/hidden{
	dir = 4
	},
/turf/open/floor/plasteel/tech/grid,
/area/engine/engineering)
"LC" = (
/obj/machinery/door/airlock/external{
	req_access_txt = "10; 13"
	},
/obj/structure/cable,
/obj/effect/mapping_helpers/airlock/cyclelink_helper,
/obj/structure/cable/layer1,
/turf/open/floor/plating,
/area/engine/engineering)
"LI" = (
/obj/structure/cable/layer1,
/obj/structure/cable,
/turf/open/floor/plasteel/techmaint,
/area/engine/engineering)
"LV" = (
/obj/structure/lattice,
/turf/open/space/basic,
/area/space/nearstation)
"LY" = (
/obj/machinery/power/emitter/anchored{
	dir = 8;
	state = 2
	},
/obj/structure/cable,
/obj/structure/cable/layer1,
/turf/open/floor/plating/airless,
/area/space/nearstation)
"Nt" = (
/turf/closed/wall/r_wall,
/area/engine/engineering)
"NG" = (
/obj/structure/particle_accelerator/particle_emitter/right,
/obj/effect/turf_decal/stripes/line{
	dir = 6
	},
/turf/open/floor/monotile/dark,
/area/engine/engineering)
"Pn" = (
/obj/effect/spawner/structure/window/plasma/reinforced,
/obj/machinery/door/poddoor/shutters/preopen{
	id = "engsing";
	name = "Singularity Access"
	},
/obj/machinery/door/firedoor/window,
/obj/machinery/atmospherics/pipe/simple/scrubbers/hidden{
	dir = 4
	},
/turf/open/floor/plating,
/area/engine/engineering)
"PJ" = (
/obj/machinery/power/emitter/anchored{
	dir = 4;
	state = 2
	},
/obj/structure/cable,
/obj/structure/cable/layer1,
/turf/open/floor/plating/airless,
/area/space/nearstation)
"QY" = (
/obj/structure/cable,
/obj/machinery/atmospherics/pipe/manifold/supply/hidden{
	dir = 4
	},
/turf/open/floor/plasteel/techmaint,
/area/engine/engineering)
"RY" = (
/obj/structure/cable/layer1,
/obj/structure/cable,
/obj/machinery/atmospherics/pipe/simple/scrubbers/hidden/layer1,
/obj/machinery/atmospherics/pipe/simple/scrubbers/hidden,
/turf/open/floor/plasteel/techmaint,
/area/engine/engineering)
"Sg" = (
/obj/effect/spawner/structure/window/plasma/reinforced,
/obj/machinery/door/poddoor/shutters/preopen{
	id = "engsing";
	name = "Singularity Access"
	},
/obj/machinery/door/firedoor/window,
/obj/machinery/atmospherics/pipe/simple/supply/hidden{
	dir = 5
	},
/turf/open/floor/plating,
/area/engine/engineering)
"Sr" = (
/obj/machinery/door/airlock/external{
	req_access_txt = "10; 13"
	},
/obj/structure/cable,
/obj/effect/mapping_helpers/airlock/cyclelink_helper,
/obj/machinery/atmospherics/pipe/simple/scrubbers/hidden{
	dir = 4
	},
/obj/structure/cable/layer1,
/turf/open/floor/plating,
/area/engine/engineering)
"SO" = (
/obj/effect/turf_decal/stripes/line{
	dir = 5
	},
/turf/open/floor/monotile/dark,
/area/engine/engineering)
"Tu" = (
/obj/structure/sign/warning/radiation,
/obj/machinery/atmospherics/pipe/simple/supply/hidden{
	dir = 5
	},
/turf/closed/wall,
/area/engine/engineering)
"Us" = (
/obj/structure/cable,
/turf/open/floor/plating/airless,
/area/space/nearstation)
"VC" = (
/obj/machinery/power/emitter/anchored{
	dir = 8;
	state = 2
	},
/obj/structure/cable,
/turf/open/floor/plating/airless,
/area/space/nearstation)
"VD" = (
/obj/effect/turf_decal/stripes/line{
	dir = 9
	},
/turf/open/floor/monotile/dark,
/area/engine/engineering)
"Wa" = (
/obj/structure/particle_accelerator/power_box,
/turf/open/floor/monotile/dark,
/area/engine/engineering)
"Wt" = (
/obj/machinery/atmospherics/pipe/simple/supply/hidden,
/obj/structure/cable,
/turf/open/floor/plasteel/techmaint,
/area/engine/engineering)
"Xl" = (
/obj/machinery/power/emitter/anchored{
	dir = 4;
	state = 2
	},
/obj/structure/cable,
/turf/open/floor/plating/airless,
/area/space/nearstation)
"XL" = (
/obj/machinery/atmospherics/pipe/simple/scrubbers/hidden/layer1{
	dir = 10;
	icon_state = "pipe11-1"
	},
/obj/machinery/button/door{
	id = "engineaccess";
	name = "Engine Access Lockdown";
	pixel_x = 24;
	req_one_access_txt = "10"
	},
/turf/open/floor/plasteel/techmaint,
/area/engine/engineering)

(1,1,1) = {"
fb
fb
fb
fb
fb
fb
fb
fb
Nt
Nt
Nt
Nt
Nt
Nt
Nt
Nt
Nt
Nt
Nt
Nt
Nt
Nt
"}
(2,1,1) = {"
fb
fb
Ir
ed
ed
lw
ed
Tu
Nt
ww
ww
ww
ww
ww
ww
PJ
Hv
dU
dU
dU
go
Xl
"}
(3,1,1) = {"
Wt
Wt
QY
kU
fb
mx
Nt
lR
Nt
ww
ly
ly
ly
ly
ly
Ft
wx
wx
kO
wx
wx
Us
"}
(4,1,1) = {"
iz
iz
eV
iz
iz
tA
LC
ht
kQ
ww
ly
LV
wx
wx
wx
un
Ft
Ft
Ft
jV
jV
Fk
"}
(5,1,1) = {"
iz
iz
eV
iz
iz
Li
mu
vj
Nt
bq
wx
LV
LV
LV
LV
pe
wx
wx
LV
wx
wx
GY
"}
(6,1,1) = {"
iz
VD
CS
mU
JN
tA
Pn
Hv
wx
LV
wx
LV
wx
wx
wx
pe
wx
wx
LV
wx
wx
GY
"}
(7,1,1) = {"
sh
pH
nO
Wa
xf
tA
Pn
Hv
LV
LV
LV
LV
LV
LV
LV
pe
LV
LV
uO
LV
LV
GY
"}
(8,1,1) = {"
iL
SO
xe
xe
NG
tA
Pn
Hv
wx
LV
wx
LV
wx
wx
wx
pe
wx
wx
LV
wx
wx
GY
"}
(9,1,1) = {"
iz
iz
iz
iz
iz
Dv
By
Sg
Nt
bq
wx
LV
LV
LV
LV
pe
wx
wx
LV
wx
wx
GY
"}
(10,1,1) = {"
iz
iz
iz
iz
iz
BY
Sr
mr
kQ
ww
ly
LV
wx
wx
wx
un
Ft
Ft
Ft
jV
jV
Fk
"}
(11,1,1) = {"
fb
fb
fb
iJ
fb
LI
uv
od
Nt
ww
ly
ly
ly
ly
ly
Ft
wx
wx
kO
wx
wx
at
"}
(12,1,1) = {"
LI
LI
LI
Hq
sZ
RY
Do
HE
Nt
ww
ww
ww
ww
ww
ww
LY
Hv
dU
dU
dU
xE
VC
"}
(13,1,1) = {"
ch
ch
aA
ch
aA
fb
XL
pJ
Nt
Nt
Nt
Nt
Nt
Nt
Nt
Nt
Nt
Nt
Nt
Nt
Nt
Nt
"}
