//MAP CONVERTED BY dmm2tgm.py THIS HEADER COMMENT PREVENTS RECONVERSION, DO NOT REMOVE
"cy" = (
/obj/machinery/power/emitter/anchored{
	dir = 4;
	state = 2
	},
/obj/structure/cable,
/obj/structure/cable/layer1,
/turf/open/floor/plating,
/area/space/nearstation)
"cK" = (
/obj/machinery/light{
	dir = 8
	},
/turf/open/floor/plating,
/area/space/nearstation)
"cR" = (
/obj/structure/particle_accelerator/particle_emitter/right,
/obj/effect/turf_decal/stripes/line{
	dir = 6
	},
/turf/open/floor/monotile/dark,
/area/engine/engineering)
"dv" = (
/obj/machinery/atmospherics/pipe/simple/supply/hidden,
/obj/structure/cable,
/turf/open/floor/plasteel/techmaint,
/area/engine/engineering)
"dD" = (
/obj/effect/spawner/structure/window/plasma/reinforced,
/obj/machinery/door/poddoor/shutters/preopen{
	id = "engsing";
	name = "Tesla Access"
	},
/obj/machinery/door/firedoor/window,
/obj/machinery/atmospherics/pipe/simple/scrubbers/hidden{
	dir = 9
	},
/turf/open/floor/plating,
/area/engine/engineering)
"dE" = (
/obj/machinery/power/emitter/anchored{
	dir = 8;
	state = 2
	},
/obj/structure/cable,
/obj/structure/cable/layer1,
/turf/open/floor/plating,
/area/space/nearstation)
"ep" = (
/turf/open/floor/plasteel/tech/grid,
/area/engine/engineering)
"eI" = (
/turf/closed/wall/r_wall,
/area/engine/engineering)
"fP" = (
/obj/machinery/light{
	dir = 4
	},
/turf/open/floor/plating,
/area/space/nearstation)
"gb" = (
/obj/structure/cable/layer1,
/obj/structure/cable,
/obj/machinery/atmospherics/pipe/simple/scrubbers/hidden/layer1,
/obj/machinery/atmospherics/pipe/simple/scrubbers/hidden,
/turf/open/floor/plasteel/techmaint,
/area/engine/engineering)
"gJ" = (
/obj/structure/cable/layer1,
/obj/item/clothing/shoes/workboots,
/obj/effect/decal/remains/human,
/turf/open/floor/plating{
	icon_state = "platingdmg2"
	},
/area/space/nearstation)
"gZ" = (
/obj/effect/turf_decal/stripes/box,
/obj/machinery/field/generator,
/obj/structure/cable/layer1,
/obj/structure/cable,
/turf/open/floor/plating,
/area/space/nearstation)
"hL" = (
/obj/structure/cable/layer1,
/obj/structure/cable,
/obj/machinery/light,
/obj/machinery/atmospherics/pipe/simple/supply/hidden{
	dir = 10
	},
/turf/open/floor/plasteel/tech/grid,
/area/engine/engineering)
"iD" = (
/obj/structure/cable,
/obj/effect/turf_decal/stripes/box,
/obj/machinery/power/tesla_coil,
/turf/open/floor/plating,
/area/space/nearstation)
"jg" = (
/obj/machinery/light{
	dir = 1
	},
/turf/open/floor/plasteel/tech/grid,
/area/engine/engineering)
"ka" = (
/obj/machinery/camera{
	c_tag = "Engineering Singularity";
	dir = 6;
	network = list("ss13","engine");
	upgrades = 2
	},
/turf/open/floor/plasteel/tech/grid,
/area/engine/engineering)
"kF" = (
/obj/machinery/power/emitter/anchored{
	dir = 8;
	state = 2
	},
/obj/structure/cable,
/turf/open/floor/plating,
/area/space/nearstation)
"lG" = (
/obj/structure/cable,
/obj/structure/cable/layer1,
/turf/open/floor/plating,
/area/space/nearstation)
"lH" = (
/obj/effect/turf_decal/stripes/line{
	dir = 4
	},
/turf/open/floor/monotile/dark,
/area/engine/engineering)
"mr" = (
/obj/machinery/the_singularitygen/tesla,
/turf/open/floor/plating,
/area/space/nearstation)
"mD" = (
/obj/structure/lattice/catwalk,
/turf/open/space/basic,
/area/space/nearstation)
"nk" = (
/obj/structure/cable/multilayer{
	cable_layer = 3
	},
/obj/machinery/power/grounding_rod,
/obj/effect/turf_decal/stripes/box,
/turf/open/floor/plating,
/area/space/nearstation)
"pb" = (
/obj/effect/turf_decal/stripes/line{
	dir = 4
	},
/obj/machinery/atmospherics/pipe/simple/scrubbers/hidden/layer1{
	dir = 5;
	icon_state = "pipe11-1"
	},
/turf/open/floor/plasteel/techmaint,
/area/engine/engineering)
"pz" = (
/obj/machinery/atmospherics/pipe/simple/supply/hidden{
	dir = 4
	},
/obj/machinery/light{
	dir = 8
	},
/obj/structure/closet/emcloset{
	anchored = 1
	},
/turf/open/floor/plating/airless,
/area/engine/engineering)
"qh" = (
/obj/machinery/door/airlock/external{
	req_access_txt = "10; 13"
	},
/obj/structure/cable,
/obj/effect/mapping_helpers/airlock/cyclelink_helper,
/obj/machinery/atmospherics/pipe/simple/scrubbers/hidden{
	dir = 4
	},
/obj/structure/cable/layer1,
/turf/open/floor/plating,
/area/engine/engineering)
"qi" = (
/obj/structure/particle_accelerator/particle_emitter/left,
/obj/structure/cable,
/obj/effect/turf_decal/stripes/line{
	dir = 10
	},
/turf/open/floor/monotile/dark,
/area/engine/engineering)
"qR" = (
/obj/structure/cable,
/turf/closed/wall/r_wall,
/area/engine/engineering)
"rW" = (
/obj/machinery/atmospherics/components/unary/vent_pump/on{
	dir = 1
	},
/turf/open/floor/plasteel/techmaint,
/area/engine/engineering)
"su" = (
/obj/machinery/atmospherics/pipe/simple/supply/hidden,
/turf/open/floor/plasteel/techmaint,
/area/engine/engineering)
"sR" = (
/obj/machinery/door/airlock/external{
	req_access_txt = "10; 13"
	},
/obj/structure/cable,
/obj/effect/mapping_helpers/airlock/cyclelink_helper,
/obj/structure/cable/layer1,
/turf/open/floor/plating,
/area/engine/engineering)
"vd" = (
/obj/structure/cable/layer1,
/obj/structure/cable,
/turf/open/floor/plasteel/techmaint,
/area/engine/engineering)
"wH" = (
/obj/structure/cable,
/obj/effect/turf_decal/stripes/line{
	dir = 8
	},
/turf/open/floor/monotile/dark,
/area/engine/engineering)
"xC" = (
/obj/machinery/power/grounding_rod,
/obj/effect/turf_decal/stripes/box,
/turf/open/floor/plating,
/area/space/nearstation)
"xO" = (
/obj/machinery/atmospherics/pipe/simple/scrubbers/hidden{
	dir = 4
	},
/turf/closed/wall/r_wall,
/area/engine/engineering)
"yg" = (
/obj/structure/cable/multilayer{
	cable_layer = 1
	},
/obj/machinery/power/terminal{
	dir = 4;
	icon_state = "term"
	},
/turf/open/floor/plasteel/techmaint,
/area/engine/engineering)
"yv" = (
/obj/effect/spawner/structure/window/plasma/reinforced,
/obj/machinery/door/poddoor/shutters/preopen{
	id = "engsing";
	name = "Tesla Access"
	},
/obj/machinery/door/firedoor/window,
/obj/machinery/atmospherics/pipe/simple/supply/hidden{
	dir = 5
	},
/turf/open/floor/plating,
/area/engine/engineering)
"Ag" = (
/obj/machinery/atmospherics/pipe/simple/scrubbers/hidden{
	dir = 9
	},
/obj/structure/sign/warning/electricshock,
/turf/closed/wall,
/area/engine/engineering)
"BF" = (
/obj/structure/lattice,
/turf/open/space/basic,
/area/space/nearstation)
"BK" = (
/obj/structure/lattice/catwalk,
/turf/open/space,
/area/space/nearstation)
"BQ" = (
/obj/effect/turf_decal/stripes/line{
	dir = 9
	},
/turf/open/floor/monotile/dark,
/area/engine/engineering)
"CH" = (
/obj/structure/particle_accelerator/end_cap,
/obj/effect/turf_decal/stripes/line{
	dir = 1
	},
/turf/open/floor/monotile/dark,
/area/engine/engineering)
"Dk" = (
/obj/structure/cable,
/obj/effect/turf_decal/stripes/line{
	dir = 1
	},
/obj/machinery/atmospherics/components/binary/dp_vent_pump{
	dir = 4
	},
/obj/machinery/advanced_airlock_controller{
	pixel_x = 30;
	pixel_y = 30
	},
/obj/structure/cable/layer1,
/turf/open/floor/plating,
/area/engine/engineering)
"Do" = (
/obj/effect/turf_decal/stripes/box,
/obj/machinery/field/generator,
/turf/open/floor/plating,
/area/space/nearstation)
"DI" = (
/obj/structure/cable,
/obj/machinery/door/airlock/external{
	req_access_txt = "10; 13"
	},
/obj/effect/mapping_helpers/airlock/cyclelink_helper{
	dir = 1
	},
/obj/machinery/door/poddoor/shutters/preopen{
	id = "engsing";
	name = "Tesla Access"
	},
/obj/structure/cable/layer1,
/turf/open/floor/plating,
/area/engine/engineering)
"Gp" = (
/obj/structure/cable/layer1,
/obj/structure/cable,
/turf/open/floor/plasteel/tech/grid,
/area/engine/engineering)
"GC" = (
/obj/structure/cable,
/turf/open/floor/plasteel/techmaint,
/area/engine/engineering)
"Hf" = (
/obj/structure/lattice/catwalk,
/obj/item/stack/marker_beacon{
	anchored = 1;
	icon_state = "markerburgundy-on";
	light_color = "#FA644B";
	light_power = 3;
	light_range = 2;
	name = "landing marker";
	picked_color = "Burgundy"
	},
/turf/open/space/basic,
/area/space/nearstation)
"Hs" = (
/obj/machinery/power/emitter/anchored{
	dir = 4;
	state = 2
	},
/obj/structure/cable,
/turf/open/floor/plating,
/area/space/nearstation)
"HD" = (
/obj/effect/spawner/structure/window/plasma/reinforced,
/obj/machinery/door/poddoor/shutters/preopen{
	id = "engsing";
	name = "Tesla Access"
	},
/obj/machinery/door/firedoor/window,
/obj/machinery/atmospherics/pipe/simple/scrubbers/hidden{
	dir = 4
	},
/turf/open/floor/plating,
/area/engine/engineering)
"Ib" = (
/obj/structure/cable/layer1,
/obj/structure/cable,
/obj/machinery/atmospherics/pipe/layer_manifold,
/turf/open/floor/plasteel/techmaint,
/area/engine/engineering)
"IL" = (
/obj/structure/cable/layer1,
/turf/open/floor/plating,
/area/space/nearstation)
"Jk" = (
/obj/effect/turf_decal/stripes/line{
	dir = 5
	},
/turf/open/floor/monotile/dark,
/area/engine/engineering)
"JI" = (
/turf/open/space/basic,
/area/space)
"JM" = (
/obj/structure/cable/layer1,
/obj/structure/cable,
/obj/machinery/atmospherics/pipe/simple/supply/hidden{
	dir = 4
	},
/turf/open/floor/plasteel/tech/grid,
/area/engine/engineering)
"Lg" = (
/obj/machinery/atmospherics/pipe/simple/supply/hidden{
	dir = 6
	},
/turf/open/floor/plasteel/techmaint,
/area/engine/engineering)
"LK" = (
/obj/machinery/atmospherics/pipe/simple/scrubbers/visible{
	dir = 4
	},
/obj/machinery/light{
	dir = 4
	},
/obj/structure/closet/emcloset{
	anchored = 1
	},
/turf/open/floor/plating/airless,
/area/engine/engineering)
"LN" = (
/obj/structure/cable/layer1,
/obj/structure/cable,
/obj/machinery/light,
/obj/machinery/atmospherics/pipe/simple/supply/hidden{
	dir = 4
	},
/turf/open/floor/plasteel/tech/grid,
/area/engine/engineering)
"LV" = (
/obj/structure/cable,
/obj/effect/turf_decal/stripes/line{
	dir = 1
	},
/obj/machinery/atmospherics/components/binary/dp_vent_pump{
	dir = 4
	},
/obj/machinery/advanced_airlock_controller{
	pixel_x = -30;
	pixel_y = 30
	},
/obj/structure/cable/layer1,
/turf/open/floor/plating,
/area/engine/engineering)
"Mq" = (
/obj/structure/sign/warning/vacuum/external,
/obj/machinery/atmospherics/pipe/simple/scrubbers/hidden{
	dir = 6
	},
/turf/closed/wall,
/area/engine/engineering)
"MM" = (
/obj/structure/cable,
/obj/machinery/atmospherics/pipe/manifold/supply/hidden{
	dir = 4
	},
/turf/open/floor/plasteel/techmaint,
/area/engine/engineering)
"MS" = (
/obj/machinery/atmospherics/components/unary/vent_scrubber/on/layer1{
	dir = 4;
	icon_state = "scrub_map_on-1"
	},
/turf/open/floor/plasteel/techmaint,
/area/engine/engineering)
"OU" = (
/obj/machinery/camera{
	c_tag = "Engineering Tesla";
	dir = 10;
	network = list("ss13","engine")
	},
/obj/effect/turf_decal/stripes/line,
/obj/effect/turf_decal/stripes/line{
	dir = 1
	},
/turf/open/floor/plating,
/area/space/nearstation)
"Pb" = (
/turf/open/floor/plating,
/area/space/nearstation)
"Qn" = (
/turf/open/floor/plating/airless,
/area/space/nearstation)
"QP" = (
/obj/structure/particle_accelerator/particle_emitter/center,
/obj/effect/turf_decal/stripes/line,
/turf/open/floor/monotile/dark,
/area/engine/engineering)
"RE" = (
/obj/effect/turf_decal/stripes/line{
	dir = 1
	},
/obj/effect/turf_decal/stripes/line,
/turf/open/floor/plating,
/area/space/nearstation)
"SJ" = (
/obj/structure/cable,
/turf/open/floor/plasteel/tech/grid,
/area/engine/engineering)
"SO" = (
/turf/open/floor/plasteel/techmaint,
/area/engine/engineering)
"Tz" = (
/obj/effect/turf_decal/stripes/box,
/obj/machinery/field/generator,
/obj/structure/cable/layer1,
/obj/structure/cable,
/obj/structure/cable/layer1,
/turf/open/floor/plating,
/area/space/nearstation)
"TQ" = (
/obj/machinery/button/door{
	id = "engsing";
	name = "Tesla Access";
	pixel_y = -24;
	req_access_txt = "10"
	},
/obj/machinery/atmospherics/pipe/simple/supply/hidden{
	dir = 4
	},
/turf/open/floor/plasteel/techmaint,
/area/engine/engineering)
"Uk" = (
/obj/structure/cable/layer1,
/obj/structure/cable,
/obj/machinery/atmospherics/pipe/simple/scrubbers/hidden/layer1{
	dir = 10;
	icon_state = "pipe11-1"
	},
/turf/open/floor/plasteel/techmaint,
/area/engine/engineering)
"Ur" = (
/obj/machinery/particle_accelerator/control_box,
/obj/structure/cable,
/obj/effect/turf_decal/stripes/line{
	dir = 8
	},
/turf/open/floor/monotile/dark,
/area/engine/engineering)
"Wm" = (
/obj/structure/cable/layer1,
/obj/structure/cable,
/obj/structure/lattice/catwalk,
/turf/open/floor/plating/airless,
/area/space/nearstation)
"XP" = (
/obj/machinery/atmospherics/pipe/simple/scrubbers/hidden/layer1{
	dir = 5;
	icon_state = "pipe11-1"
	},
/obj/machinery/atmospherics/pipe/manifold/scrubbers/hidden{
	dir = 4
	},
/turf/open/floor/plasteel/techmaint,
/area/engine/engineering)
"XS" = (
/obj/machinery/atmospherics/pipe/simple/scrubbers/hidden/layer1{
	dir = 10;
	icon_state = "pipe11-1"
	},
/obj/machinery/button/door{
	id = "engineaccess";
	name = "Engine Access Lockdown";
	pixel_x = 24;
	req_one_access_txt = "10"
	},
/turf/open/floor/plasteel/techmaint,
/area/engine/engineering)
"XY" = (
/obj/machinery/atmospherics/pipe/manifold/supply/hidden{
	dir = 8
	},
/turf/open/floor/plasteel/techmaint,
/area/engine/engineering)
"Yh" = (
/obj/structure/particle_accelerator/power_box,
/turf/open/floor/monotile/dark,
/area/engine/engineering)
"YW" = (
/obj/structure/particle_accelerator/fuel_chamber,
/turf/open/floor/monotile/dark,
/area/engine/engineering)
"Zl" = (
/obj/structure/sign/warning/vacuum/external,
/obj/machinery/atmospherics/pipe/simple/scrubbers/hidden{
	dir = 4
	},
/obj/machinery/atmospherics/pipe/simple/supply/hidden,
/turf/closed/wall,
/area/engine/engineering)
"ZZ" = (
/obj/machinery/atmospherics/pipe/simple/supply/hidden{
	dir = 5
	},
/obj/structure/sign/warning/electricshock,
/turf/closed/wall,
/area/engine/engineering)

(1,1,1) = {"
SO
SO
SO
SO
SO
SO
SO
SO
eI
eI
eI
eI
eI
eI
eI
qR
qR
qR
qR
qR
qR
qR
"}
(2,1,1) = {"
SO
SO
Lg
su
su
XY
su
ZZ
eI
Wm
Wm
Wm
Wm
Wm
Wm
cy
IL
IL
IL
Pb
cK
Hs
"}
(3,1,1) = {"
dv
dv
MM
rW
SO
TQ
eI
pz
eI
Wm
BK
BK
BK
BK
BK
lG
JI
iD
nk
iD
JI
Pb
"}
(4,1,1) = {"
ep
ep
SJ
ep
ep
JM
sR
LV
DI
Wm
BK
BF
JI
JI
JI
Tz
mD
mD
mD
mD
mD
Do
"}
(5,1,1) = {"
ep
ep
SJ
ep
ep
LN
Mq
dD
eI
Hf
JI
BF
BF
BF
BF
RE
JI
JI
BF
JI
JI
RE
"}
(6,1,1) = {"
ep
BQ
Ur
wH
qi
JM
HD
Qn
JI
BF
JI
BF
JI
JI
xC
RE
JI
JI
BF
JI
JI
RE
"}
(7,1,1) = {"
jg
CH
YW
Yh
QP
JM
HD
Qn
BF
BF
BF
BF
BF
BF
BF
RE
BF
BF
mr
BF
BF
OU
"}
(8,1,1) = {"
ka
Jk
lH
lH
cR
JM
HD
Qn
JI
BF
JI
BF
JI
JI
xC
RE
JI
JI
BF
JI
JI
RE
"}
(9,1,1) = {"
ep
ep
ep
ep
ep
hL
Zl
yv
eI
Hf
JI
BF
BF
BF
BF
RE
JI
JI
BF
JI
JI
RE
"}
(10,1,1) = {"
ep
ep
ep
ep
ep
Gp
qh
Dk
DI
Wm
BK
BF
JI
JI
JI
gZ
mD
mD
mD
mD
mD
Do
"}
(11,1,1) = {"
SO
SO
SO
MS
SO
vd
xO
LK
eI
Wm
BK
BK
BK
BK
BK
lG
JI
iD
nk
iD
JI
Pb
"}
(12,1,1) = {"
vd
vd
vd
Uk
Ib
gb
XP
Ag
eI
Wm
Wm
Wm
Wm
Wm
Wm
dE
IL
gJ
IL
Pb
fP
kF
"}
(13,1,1) = {"
yg
yg
GC
yg
GC
SO
XS
pb
eI
eI
eI
eI
eI
eI
eI
qR
qR
qR
qR
qR
qR
qR
"}
