//MAP CONVERTED BY dmm2tgm.py THIS HEADER COMMENT PREVENTS RECONVERSION, DO NOT REMOVE
"ao" = (
/obj/effect/turf_decal/stripes/line{
	dir = 10
	},
/turf/open/floor/plasteel/tech/grid,
/area/engine/engineering)
"aC" = (
/obj/machinery/atmospherics/components/binary/pump,
/turf/open/floor/plasteel/tech/grid,
/area/engine/engineering)
"aP" = (
/obj/machinery/atmospherics/pipe/manifold/purple/visible{
	dir = 4
	},
/turf/open/floor/plasteel/tech/grid,
/area/engine/engineering)
"bl" = (
/obj/effect/turf_decal/arrows/red{
	dir = 1;
	icon_state = "arrows_red";
	pixel_x = -5
	},
/obj/machinery/atmospherics/components/binary/pump{
	dir = 1
	},
/turf/open/floor/plasteel/tech/grid,
/area/engine/engineering)
"br" = (
/obj/machinery/atmospherics/pipe/simple/purple/visible{
	dir = 5
	},
/obj/effect/turf_decal/stripes/line{
	dir = 8
	},
/turf/open/floor/plasteel/tech/grid,
/area/engine/engineering)
"cj" = (
/obj/machinery/atmospherics/pipe/manifold/cyan/visible{
	dir = 1
	},
/obj/machinery/light/floor,
/turf/open/floor/monotile/steel,
/area/engine/engineering)
"cQ" = (
/obj/effect/turf_decal/stripes/line{
	dir = 8
	},
/obj/machinery/light{
	dir = 8
	},
/obj/machinery/atmospherics/pipe/simple/orange/visible,
/obj/effect/turf_decal/arrows/red{
	dir = 1;
	pixel_x = -5
	},
/turf/open/floor/plasteel/tech/grid,
/area/engine/engineering)
"cR" = (
/obj/machinery/atmospherics/pipe/simple/cyan/visible,
/turf/open/floor/plasteel/tech/grid,
/area/engine/engineering)
"dv" = (
/obj/machinery/atmospherics/pipe/simple/orange/visible{
	dir = 6
	},
/turf/open/floor/plasteel/tech/grid,
/area/engine/engineering)
"dW" = (
/obj/structure/railing,
/turf/open/floor/plasteel/tech/grid,
/area/engine/engineering)
"ep" = (
/obj/structure/railing{
	dir = 5
	},
/turf/open/floor/plasteel/tech/grid,
/area/engine/engineering)
"eJ" = (
/obj/machinery/atmospherics/pipe/simple/cyan/visible{
	dir = 4
	},
/obj/machinery/atmospherics/pipe/simple/purple/visible,
/obj/effect/turf_decal/stripes/corner{
	dir = 8
	},
/turf/open/floor/plasteel/tech/grid,
/area/engine/engineering)
"eL" = (
/obj/effect/turf_decal/stripes/line{
	dir = 10
	},
/obj/machinery/atmospherics/components/binary/pump/on{
	dir = 4
	},
/obj/machinery/light,
/turf/open/floor/plasteel/tech/grid,
/area/engine/engineering)
"ga" = (
/obj/structure/railing,
/obj/machinery/atmospherics/pipe/simple/orange/visible,
/turf/open/floor/plasteel/tech/grid,
/area/engine/engineering)
"gk" = (
/obj/machinery/atmospherics/components/binary/pump{
	dir = 8
	},
/turf/open/floor/plasteel/tech/grid,
/area/engine/engineering)
"gr" = (
/obj/structure/railing{
	dir = 9
	},
/turf/open/floor/plasteel/tech/grid,
/area/engine/engineering)
"hd" = (
/obj/effect/turf_decal/stripes/line{
	dir = 8
	},
/obj/machinery/atmospherics/pipe/simple/purple/visible{
	dir = 6
	},
/turf/open/floor/plasteel/tech/grid,
/area/engine/engineering)
"hh" = (
/obj/structure/cable/multilayer{
	cable_layer = 1
	},
/obj/machinery/power/terminal{
	dir = 4;
	icon_state = "term"
	},
/obj/effect/turf_decal/stripes/line{
	dir = 4
	},
/turf/open/floor/plasteel/tech/grid,
/area/engine/engineering)
"hs" = (
/obj/machinery/airalarm/all_access{
	dir = 1;
	pixel_y = -24
	},
/obj/effect/turf_decal/stripes/line,
/obj/machinery/light,
/turf/open/floor/plasteel/tech/grid,
/area/engine/engineering)
"iw" = (
/obj/effect/turf_decal/stripes/line{
	dir = 8
	},
/obj/machinery/atmospherics/pipe/simple/purple/visible,
/turf/open/floor/plasteel/tech/grid,
/area/engine/engineering)
"jg" = (
/obj/machinery/atmospherics/pipe/simple/purple/visible,
/turf/open/floor/plasteel/tech/grid,
/area/engine/engineering)
"jP" = (
/obj/machinery/atmospherics/pipe/simple/scrubbers/hidden{
	dir = 4
	},
/turf/closed/wall/r_wall,
/area/engine/engineering)
"kj" = (
/obj/machinery/atmospherics/pipe/simple/orange/visible,
/obj/machinery/meter,
/turf/open/floor/plasteel/tech/grid,
/area/engine/engineering)
"kB" = (
/obj/machinery/button/door{
	id = "burnchamb";
	name = "Burn Chamber Shutters Control";
	pixel_x = 6;
	pixel_y = -26;
	req_access_txt = "10"
	},
/obj/machinery/button/ignition{
	id = "burnigniter";
	pixel_x = -6;
	pixel_y = -26
	},
/obj/effect/turf_decal/stripes/line,
/obj/machinery/light,
/turf/open/floor/plasteel/tech/grid,
/area/engine/engineering)
"ln" = (
/obj/effect/turf_decal/stripes/line{
	dir = 8
	},
/obj/machinery/atmospherics/components/binary/pump{
	dir = 1
	},
/turf/open/floor/plasteel/tech/grid,
/area/engine/engineering)
"lK" = (
/obj/machinery/atmospherics/pipe/simple/purple/visible{
	dir = 9
	},
/turf/open/floor/plasteel/tech/grid,
/area/engine/engineering)
"mv" = (
/obj/machinery/igniter{
	id = "burnigniter";
	luminosity = 2
	},
/obj/machinery/atmospherics/pipe/heat_exchanging/simple{
	dir = 4
	},
/turf/open/floor/engine,
/area/engine/engineering)
"mM" = (
/obj/machinery/atmospherics/components/unary/portables_connector/visible,
/obj/machinery/portable_atmospherics/canister,
/obj/effect/turf_decal/stripes/box,
/turf/open/floor/plasteel/tech/grid,
/area/engine/engineering)
"no" = (
/obj/effect/turf_decal/stripes/end,
/turf/open/floor/plasteel/tech/grid,
/area/engine/engineering)
"nJ" = (
/obj/machinery/atmospherics/pipe/simple/orange/visible,
/obj/effect/turf_decal/stripes/line,
/obj/machinery/meter,
/obj/effect/turf_decal/arrows/red{
	pixel_x = -5
	},
/turf/open/floor/plasteel/tech/grid,
/area/engine/engineering)
"nM" = (
/obj/effect/turf_decal/stripes/line{
	dir = 1
	},
/obj/structure/cable/layer1,
/obj/machinery/atmospherics/components/binary/pump/on{
	dir = 1
	},
/obj/structure/cable,
/turf/open/floor/plasteel/tech/grid,
/area/engine/engineering)
"nO" = (
/obj/effect/turf_decal/arrows/red{
	dir = 1;
	icon_state = "arrows_red";
	pixel_x = -5
	},
/obj/machinery/atmospherics/pipe/manifold/orange/visible{
	dir = 4
	},
/turf/open/floor/plasteel/tech/grid,
/area/engine/engineering)
"om" = (
/obj/structure/railing{
	dir = 4
	},
/turf/open/floor/plasteel/tech/grid,
/area/engine/engineering)
"oK" = (
/obj/machinery/atmospherics/pipe/simple/orange/hidden,
/obj/machinery/light/floor,
/turf/open/floor/monotile/steel,
/area/engine/engineering)
"pU" = (
/obj/machinery/atmospherics/pipe/heat_exchanging/simple,
/turf/open/floor/engine,
/area/engine/engineering)
"pW" = (
/obj/structure/cable/multilayer{
	cable_layer = 3
	},
/turf/open/floor/monotile/steel,
/area/engine/engineering)
"qk" = (
/obj/structure/railing{
	dir = 1
	},
/obj/machinery/atmospherics/components/binary/pump{
	dir = 1
	},
/turf/open/floor/plasteel/tech/grid,
/area/engine/engineering)
"qF" = (
/obj/machinery/atmospherics/components/binary/pump{
	dir = 1
	},
/turf/open/floor/monotile/steel,
/area/engine/engineering)
"qG" = (
/obj/structure/railing{
	dir = 6
	},
/obj/machinery/atmospherics/pipe/simple/cyan/visible{
	dir = 4
	},
/turf/open/floor/plasteel/tech/grid,
/area/engine/engineering)
"ra" = (
/obj/effect/turf_decal/stripes/line{
	dir = 4
	},
/obj/machinery/atmospherics/components/unary/portables_connector/visible{
	dir = 8
	},
/turf/open/floor/plasteel/tech/grid,
/area/engine/engineering)
"rZ" = (
/obj/machinery/atmospherics/pipe/simple/orange/visible{
	dir = 5
	},
/turf/open/floor/plasteel/tech/grid,
/area/engine/engineering)
"sa" = (
/obj/structure/cable,
/turf/open/floor/monotile/steel,
/area/engine/engineering)
"sq" = (
/obj/structure/railing{
	dir = 1
	},
/turf/open/floor/plasteel/tech/grid,
/area/engine/engineering)
"tn" = (
/obj/effect/spawner/structure/window/plasma/reinforced,
/obj/machinery/atmospherics/pipe/simple/scrubbers/visible{
	dir = 4
	},
/obj/machinery/door/firedoor/window,
/turf/open/floor/engine,
/area/engine/engineering)
"tq" = (
/obj/machinery/atmospherics/pipe/manifold/orange/visible{
	dir = 4
	},
/turf/open/floor/plasteel/tech/grid,
/area/engine/engineering)
"tv" = (
/obj/effect/turf_decal/stripes/line{
	dir = 8
	},
/obj/machinery/atmospherics/pipe/simple/purple/visible{
	dir = 5
	},
/turf/open/floor/plasteel/tech/grid,
/area/engine/engineering)
"tx" = (
/obj/machinery/atmospherics/pipe/heat_exchanging/simple{
	dir = 5
	},
/turf/open/floor/engine,
/area/engine/engineering)
"tz" = (
/obj/effect/spawner/structure/window/plasma/reinforced,
/obj/machinery/door/poddoor/shutters/preopen{
	id = "burnchamb"
	},
/turf/open/floor/plating,
/area/engine/engineering)
"tP" = (
/obj/machinery/atmospherics/pipe/manifold/purple/visible{
	dir = 1
	},
/turf/open/floor/plasteel/tech/grid,
/area/engine/engineering)
"tT" = (
/obj/structure/railing{
	dir = 9
	},
/obj/machinery/atmospherics/components/binary/pump,
/turf/open/floor/plasteel/tech/grid,
/area/engine/engineering)
"uB" = (
/obj/machinery/atmospherics/components/binary/pump{
	dir = 4
	},
/turf/open/floor/plasteel/tech/grid,
/area/engine/engineering)
"uD" = (
/obj/structure/cable/layer1,
/obj/structure/cable,
/turf/open/floor/plasteel/tech/grid,
/area/engine/engineering)
"vh" = (
/obj/machinery/atmospherics/pipe/heat_exchanging/simple{
	dir = 9
	},
/turf/open/floor/engine,
/area/engine/engineering)
"vj" = (
/obj/effect/spawner/structure/window/plasma/reinforced,
/obj/machinery/door/poddoor/shutters/preopen{
	id = "burnchamb"
	},
/obj/machinery/atmospherics/pipe/simple/scrubbers/hidden{
	dir = 4
	},
/turf/open/floor/plating,
/area/engine/engineering)
"vs" = (
/obj/effect/turf_decal/stripes/line{
	dir = 4
	},
/obj/machinery/atmospherics/pipe/simple/scrubbers/visible{
	dir = 6
	},
/turf/open/floor/plasteel/tech/grid,
/area/engine/engineering)
"vt" = (
/obj/effect/spawner/structure/window/plasma/reinforced,
/obj/machinery/door/poddoor/shutters/preopen{
	id = "burnchamb"
	},
/obj/machinery/atmospherics/pipe/heat_exchanging/junction,
/turf/open/floor/plating,
/area/engine/engineering)
"wb" = (
/obj/structure/railing{
	dir = 6
	},
/obj/machinery/atmospherics/pipe/simple/orange/visible{
	dir = 5
	},
/turf/open/floor/plasteel/tech/grid,
/area/engine/engineering)
"wH" = (
/obj/effect/turf_decal/stripes/line{
	dir = 4
	},
/turf/open/floor/plasteel/tech/grid,
/area/engine/engineering)
"yg" = (
/obj/machinery/atmospherics/pipe/simple/orange/visible{
	dir = 10
	},
/turf/open/floor/plasteel/tech/grid,
/area/engine/engineering)
"yt" = (
/obj/effect/turf_decal/stripes/corner,
/turf/open/floor/plasteel/tech/grid,
/area/engine/engineering)
"yw" = (
/obj/effect/turf_decal/stripes/line{
	dir = 6
	},
/obj/machinery/light,
/turf/open/floor/plasteel/tech/grid,
/area/engine/engineering)
"yJ" = (
/obj/structure/railing/corner{
	dir = 1
	},
/turf/open/floor/plasteel/tech/grid,
/area/engine/engineering)
"yK" = (
/obj/structure/railing{
	dir = 4
	},
/obj/machinery/atmospherics/pipe/manifold/cyan/visible,
/turf/open/floor/plasteel/tech/grid,
/area/engine/engineering)
"zd" = (
/obj/effect/spawner/structure/window/plasma/reinforced,
/obj/machinery/door/poddoor/shutters/preopen{
	id = "burnchamb"
	},
/obj/machinery/atmospherics/pipe/heat_exchanging/junction{
	dir = 8
	},
/turf/open/floor/plating,
/area/engine/engineering)
"zp" = (
/obj/structure/cable/layer1,
/turf/open/floor/plasteel/tech/grid,
/area/engine/engineering)
"Av" = (
/obj/machinery/power/generator,
/obj/structure/cable,
/obj/effect/turf_decal/stripes/red/line,
/obj/effect/turf_decal/stripes/red/line{
	dir = 1
	},
/turf/open/floor/monotile/steel,
/area/engine/engineering)
"AN" = (
/obj/machinery/atmospherics/pipe/heat_exchanging/simple,
/obj/machinery/atmospherics/pipe/simple/scrubbers/visible{
	dir = 4
	},
/turf/open/floor/engine,
/area/engine/engineering)
"AT" = (
/obj/machinery/button/door{
	id = "burnrelease";
	name = "Burn Chamber Release Shutters Control";
	pixel_y = -24;
	req_access_txt = "10"
	},
/obj/effect/turf_decal/stripes/line,
/turf/open/floor/plasteel/tech/grid,
/area/engine/engineering)
"AY" = (
/obj/machinery/atmospherics/pipe/simple/cyan/visible{
	dir = 10
	},
/obj/machinery/meter,
/turf/open/floor/plasteel/tech/grid,
/area/engine/engineering)
"Bd" = (
/obj/machinery/atmospherics/pipe/simple/cyan/visible{
	dir = 10
	},
/turf/open/floor/monotile/steel,
/area/engine/engineering)
"Bt" = (
/obj/effect/spawner/structure/window/plasma/reinforced,
/obj/machinery/door/poddoor/shutters/preopen{
	id = "burnchamb"
	},
/obj/machinery/atmospherics/pipe/simple/purple/visible{
	dir = 4
	},
/turf/open/floor/plating,
/area/engine/engineering)
"BG" = (
/obj/effect/turf_decal/stripes/red/end{
	dir = 4
	},
/obj/item/storage/crayons,
/obj/machinery/atmospherics/pipe/simple/orange/visible,
/turf/open/floor/monotile/steel,
/area/engine/engineering)
"BJ" = (
/obj/machinery/atmospherics/pipe/simple/cyan/visible{
	dir = 5
	},
/turf/open/floor/plasteel/tech/grid,
/area/engine/engineering)
"CA" = (
/obj/structure/cable/layer1,
/obj/machinery/atmospherics/pipe/simple/orange/hidden,
/turf/open/floor/monotile/steel,
/area/engine/engineering)
"CC" = (
/obj/machinery/atmospherics/components/unary/outlet_injector/on{
	dir = 8
	},
/turf/open/floor/engine,
/area/engine/engineering)
"DO" = (
/turf/closed/wall/r_wall,
/area/engine/engineering)
"Eb" = (
/obj/machinery/atmospherics/pipe/simple/orange/visible,
/obj/effect/turf_decal/stripes/corner{
	dir = 8
	},
/obj/effect/turf_decal/arrows/red{
	dir = 1;
	pixel_x = -5
	},
/turf/open/floor/plasteel/tech/grid,
/area/engine/engineering)
"Ee" = (
/obj/machinery/atmospherics/components/binary/circulator{
	dir = 8
	},
/obj/effect/turf_decal/stripes/red/end{
	dir = 4
	},
/turf/open/floor/monotile/steel,
/area/engine/engineering)
"Eh" = (
/obj/effect/turf_decal/stripes/line{
	dir = 4
	},
/obj/machinery/atmospherics/pipe/simple/scrubbers/visible,
/turf/open/floor/plasteel/tech/grid,
/area/engine/engineering)
"Ek" = (
/obj/effect/turf_decal/stripes/line{
	dir = 8
	},
/obj/machinery/atmospherics/components/binary/pump{
	dir = 4
	},
/turf/open/floor/plasteel/tech/grid,
/area/engine/engineering)
"Eu" = (
/obj/machinery/atmospherics/pipe/simple/purple/visible{
	dir = 10
	},
/turf/open/floor/plasteel/tech/grid,
/area/engine/engineering)
"EI" = (
/turf/open/floor/plasteel/tech/grid,
/area/engine/engineering)
"EL" = (
/obj/effect/turf_decal/stripes/red/end{
	dir = 8
	},
/obj/effect/decal/cleanable/crayon,
/obj/machinery/atmospherics/pipe/simple/cyan/visible,
/turf/open/floor/monotile/steel,
/area/engine/engineering)
"ET" = (
/obj/machinery/atmospherics/pipe/heat_exchanging/simple,
/obj/machinery/atmospherics/pipe/simple/purple/visible{
	dir = 4
	},
/turf/open/floor/engine,
/area/engine/engineering)
"Fc" = (
/obj/machinery/atmospherics/components/unary/vent_scrubber/on{
	dir = 4
	},
/turf/open/floor/engine,
/area/engine/engineering)
"FB" = (
/obj/effect/turf_decal/stripes/line,
/obj/machinery/atmospherics/pipe/simple/purple/visible{
	dir = 5
	},
/turf/open/floor/plasteel/tech/grid,
/area/engine/engineering)
"Gs" = (
/obj/structure/railing/corner{
	dir = 4
	},
/turf/open/floor/plasteel/tech/grid,
/area/engine/engineering)
"Gx" = (
/obj/machinery/atmospherics/pipe/simple/orange/visible{
	dir = 9
	},
/obj/effect/turf_decal/stripes/line{
	dir = 10
	},
/obj/machinery/meter,
/turf/open/floor/plasteel/tech/grid,
/area/engine/engineering)
"GK" = (
/obj/structure/cable/layer1,
/obj/machinery/atmospherics/pipe/simple/orange/visible{
	dir = 9
	},
/obj/structure/cable,
/turf/open/floor/plasteel/tech/grid,
/area/engine/engineering)
"GL" = (
/obj/effect/turf_decal/stripes/line{
	dir = 9
	},
/obj/machinery/light{
	dir = 1
	},
/turf/open/floor/plasteel/tech/grid,
/area/engine/engineering)
"Ih" = (
/obj/machinery/atmospherics/pipe/simple/orange/visible,
/turf/open/floor/monotile/steel,
/area/engine/engineering)
"IL" = (
/obj/effect/turf_decal/stripes/line{
	dir = 4
	},
/obj/machinery/atmospherics/pipe/simple/scrubbers/visible{
	dir = 9
	},
/obj/effect/turf_decal/stripes/line{
	dir = 8
	},
/turf/open/floor/plasteel/tech/grid,
/area/engine/engineering)
"IQ" = (
/obj/effect/turf_decal/stripes/line{
	dir = 8
	},
/obj/machinery/atmospherics/components/binary/pump/on{
	dir = 8
	},
/obj/machinery/atmospherics/pipe/simple/purple/visible,
/turf/open/floor/plasteel/tech/grid,
/area/engine/engineering)
"Ki" = (
/obj/structure/cable/multilayer{
	cable_layer = 1
	},
/obj/machinery/power/terminal{
	dir = 4;
	icon_state = "term"
	},
/obj/effect/turf_decal/stripes/line{
	dir = 5
	},
/obj/machinery/light{
	dir = 1
	},
/turf/open/floor/plasteel/tech/grid,
/area/engine/engineering)
"Kv" = (
/obj/structure/railing{
	dir = 8
	},
/turf/open/floor/plasteel/tech/grid,
/area/engine/engineering)
"KS" = (
/obj/machinery/atmospherics/components/unary/portables_connector/visible{
	dir = 4
	},
/obj/machinery/portable_atmospherics/canister/nitrogen,
/obj/effect/turf_decal/stripes/box,
/turf/open/floor/plasteel/tech/grid,
/area/engine/engineering)
"KZ" = (
/obj/machinery/atmospherics/components/binary/circulator/cold{
	dir = 4
	},
/obj/effect/turf_decal/stripes/red/end{
	dir = 8
	},
/turf/open/floor/monotile/steel,
/area/engine/engineering)
"LW" = (
/obj/structure/railing{
	dir = 10
	},
/turf/open/floor/plasteel/tech/grid,
/area/engine/engineering)
"MC" = (
/obj/effect/turf_decal/stripes/line{
	dir = 6
	},
/obj/machinery/atmospherics/components/unary/portables_connector/visible{
	dir = 8
	},
/turf/open/floor/plasteel/tech/grid,
/area/engine/engineering)
"MD" = (
/obj/structure/cable/layer1,
/turf/open/floor/plasteel/stairs/medium{
	dir = 4
	},
/area/engine/engineering)
"MV" = (
/obj/effect/turf_decal/stripes/line{
	dir = 4
	},
/obj/machinery/atmospherics/components/binary/pump{
	dir = 4
	},
/turf/open/floor/plasteel/tech/grid,
/area/engine/engineering)
"MZ" = (
/obj/machinery/atmospherics/components/binary/pump,
/obj/structure/railing/corner,
/turf/open/floor/plasteel/tech/grid,
/area/engine/engineering)
"Na" = (
/obj/effect/turf_decal/stripes/line,
/turf/open/floor/plasteel/tech/grid,
/area/engine/engineering)
"Nx" = (
/turf/open/floor/plasteel/stairs/medium,
/area/engine/engineering)
"NG" = (
/obj/effect/turf_decal/stripes/line{
	dir = 8
	},
/turf/open/floor/plasteel/tech/grid,
/area/engine/engineering)
"NN" = (
/obj/effect/turf_decal/arrows/red{
	pixel_x = -5
	},
/obj/machinery/atmospherics/pipe/manifold/orange/visible{
	dir = 8
	},
/turf/open/floor/plasteel/tech/grid,
/area/engine/engineering)
"Oa" = (
/turf/open/floor/monotile/steel,
/area/engine/engineering)
"Of" = (
/obj/effect/turf_decal/stripes/line{
	dir = 4
	},
/obj/machinery/button/door{
	id = "engineaccess";
	name = "Engine Access Lockdown";
	pixel_x = 24;
	req_one_access_txt = "10"
	},
/turf/open/floor/plasteel/tech/grid,
/area/engine/engineering)
"Oi" = (
/obj/machinery/atmospherics/pipe/simple/cyan/visible{
	dir = 9
	},
/turf/open/floor/monotile/steel,
/area/engine/engineering)
"Or" = (
/obj/machinery/atmospherics/pipe/simple/orange/visible{
	dir = 4
	},
/turf/open/floor/plasteel/tech/grid,
/area/engine/engineering)
"Ov" = (
/obj/machinery/atmospherics/pipe/simple/orange/visible{
	dir = 9
	},
/turf/open/floor/plasteel/tech/grid,
/area/engine/engineering)
"OJ" = (
/obj/effect/turf_decal/stripes/line{
	dir = 4
	},
/obj/structure/cable,
/turf/open/floor/plasteel/tech/grid,
/area/engine/engineering)
"PA" = (
/obj/machinery/atmospherics/pipe/simple/orange/hidden{
	dir = 4
	},
/turf/open/floor/plasteel/stairs/medium,
/area/engine/engineering)
"PH" = (
/obj/machinery/atmospherics/pipe/simple/orange/hidden,
/turf/open/floor/monotile/steel,
/area/engine/engineering)
"PW" = (
/obj/effect/turf_decal/stripes/line{
	dir = 4
	},
/obj/machinery/light{
	dir = 4
	},
/turf/open/floor/plasteel/tech/grid,
/area/engine/engineering)
"Qk" = (
/obj/structure/railing{
	dir = 4
	},
/obj/machinery/atmospherics/pipe/simple/cyan/visible{
	dir = 4
	},
/turf/open/floor/plasteel/tech/grid,
/area/engine/engineering)
"Qy" = (
/obj/machinery/door/poddoor{
	id = "burnrelease"
	},
/turf/open/floor/plating,
/area/engine/engineering)
"QY" = (
/turf/open/floor/plasteel/stairs/medium{
	dir = 4
	},
/area/engine/engineering)
"Rd" = (
/obj/structure/railing{
	dir = 10
	},
/obj/machinery/atmospherics/pipe/simple/orange/visible{
	dir = 10
	},
/turf/open/floor/plasteel/tech/grid,
/area/engine/engineering)
"RB" = (
/obj/structure/cable/layer1,
/obj/machinery/atmospherics/pipe/simple/orange/visible,
/turf/open/floor/monotile/steel,
/area/engine/engineering)
"Sp" = (
/obj/effect/turf_decal/stripes/line{
	dir = 1
	},
/obj/structure/cable,
/turf/open/floor/plasteel/tech/grid,
/area/engine/engineering)
"SH" = (
/obj/structure/cable,
/obj/effect/turf_decal/stripes/red/line,
/obj/effect/turf_decal/stripes/red/line{
	dir = 1
	},
/obj/structure/frame/machine,
/turf/open/floor/monotile/steel,
/area/engine/engineering)
"Tr" = (
/obj/structure/railing/corner{
	dir = 8
	},
/turf/open/floor/plasteel/tech/grid,
/area/engine/engineering)
"TI" = (
/obj/effect/turf_decal/stripes/line{
	dir = 4
	},
/obj/machinery/atmospherics/pipe/simple/scrubbers/visible,
/obj/effect/turf_decal/stripes/corner{
	dir = 8
	},
/turf/open/floor/plasteel/tech/grid,
/area/engine/engineering)
"Ux" = (
/obj/effect/turf_decal/stripes/line{
	dir = 1
	},
/obj/machinery/light{
	dir = 1
	},
/obj/structure/cable,
/turf/open/floor/plasteel/tech/grid,
/area/engine/engineering)
"UA" = (
/obj/machinery/atmospherics/pipe/simple/purple/visible{
	dir = 10;
	icon_state = "pipe11-2"
	},
/turf/open/floor/plasteel/tech/grid,
/area/engine/engineering)
"UN" = (
/obj/machinery/meter,
/obj/machinery/atmospherics/pipe/manifold/orange/visible{
	dir = 1
	},
/turf/open/floor/plasteel/tech/grid,
/area/engine/engineering)
"VU" = (
/obj/machinery/atmospherics/pipe/simple/cyan/visible,
/turf/open/floor/monotile/steel,
/area/engine/engineering)
"Wc" = (
/obj/effect/turf_decal/stripes/line{
	dir = 1
	},
/obj/machinery/atmospherics/components/binary/pump/on,
/obj/structure/cable,
/turf/open/floor/plasteel/tech/grid,
/area/engine/engineering)
"Wr" = (
/obj/effect/turf_decal/arrows/red{
	pixel_x = -5
	},
/obj/machinery/atmospherics/components/binary/pump,
/turf/open/floor/plasteel/tech/grid,
/area/engine/engineering)
"WG" = (
/obj/machinery/atmospherics/pipe/simple/cyan/visible{
	dir = 4
	},
/turf/open/floor/plasteel/tech/grid,
/area/engine/engineering)
"WU" = (
/obj/machinery/atmospherics/pipe/simple/purple/visible,
/obj/effect/turf_decal/stripes/line{
	dir = 8
	},
/turf/open/floor/plasteel/tech/grid,
/area/engine/engineering)
"XF" = (
/obj/machinery/atmospherics/pipe/simple/purple/visible{
	dir = 5
	},
/obj/machinery/meter,
/turf/open/floor/plasteel/tech/grid,
/area/engine/engineering)
"XT" = (
/obj/effect/spawner/structure/window/plasma/reinforced,
/obj/machinery/door/firedoor/window,
/turf/open/floor/engine,
/area/engine/engineering)
"Zi" = (
/obj/structure/lattice,
/turf/open/space/basic,
/area/space/nearstation)
"ZC" = (
/obj/machinery/atmospherics/pipe/heat_exchanging/simple{
	dir = 6
	},
/turf/open/floor/engine,
/area/engine/engineering)
"ZF" = (
/obj/machinery/atmospherics/pipe/simple/cyan/visible{
	dir = 4
	},
/obj/machinery/light/floor,
/turf/open/floor/monotile/steel,
/area/engine/engineering)

(1,1,1) = {"
GL
NG
NG
NG
NG
Ek
hd
IQ
iw
tv
eL
DO
DO
XT
XT
XT
XT
DO
XT
XT
DO
DO
"}
(2,1,1) = {"
Sp
EI
EI
EI
EI
UA
lK
AY
BJ
Eu
eJ
WU
WU
WU
WU
br
NG
hd
ln
tv
ao
DO
"}
(3,1,1) = {"
Sp
EI
KS
KS
mM
aC
BJ
EI
WG
EI
AY
cR
cR
BJ
EI
Eu
jg
aP
XF
tP
FB
DO
"}
(4,1,1) = {"
Sp
EI
UN
Ov
mM
MZ
yK
om
qG
QY
QY
ep
om
Qk
Gs
EI
yt
PW
MV
ra
MC
DO
"}
(5,1,1) = {"
Sp
EI
uB
EI
EI
dW
cj
VU
Oi
Oa
Oa
Oa
Oa
ZF
sq
EI
hs
DO
Bt
tz
tz
DO
"}
(6,1,1) = {"
Sp
dv
tq
NN
Wr
wb
Bd
KZ
VU
qF
VU
VU
EL
Oi
ep
dv
nJ
vt
ET
pU
tx
DO
"}
(7,1,1) = {"
Ux
Or
EI
Or
EI
PA
Oa
Av
sa
pW
sa
sa
SH
Oa
Nx
Or
Na
tz
CC
Fc
mv
DO
"}
(8,1,1) = {"
Wc
Ov
EI
gk
EI
Rd
Ih
Ee
Ih
RB
Ih
Ih
BG
Ih
tT
Ov
Na
tz
ZC
AN
vh
DO
"}
(9,1,1) = {"
Sp
dv
kj
nO
bl
ga
oK
PH
PH
CA
PH
PH
PH
oK
qk
rZ
kB
DO
zd
jP
Qy
DO
"}
(10,1,1) = {"
Sp
Or
EI
EI
EI
Tr
Kv
Kv
LW
MD
QY
gr
Kv
Kv
yJ
yg
Eb
cQ
Gx
vj
Zi
DO
"}
(11,1,1) = {"
Sp
Or
EI
EI
EI
EI
EI
EI
EI
zp
EI
EI
EI
EI
EI
EI
EI
EI
AT
jP
DO
DO
"}
(12,1,1) = {"
nM
GK
uD
uD
uD
zp
zp
zp
zp
zp
yt
wH
vs
Eh
Eh
Eh
Eh
Eh
TI
IL
no
DO
"}
(13,1,1) = {"
Ki
hh
OJ
hh
OJ
wH
Of
wH
wH
wH
yw
DO
tn
XT
DO
DO
DO
DO
DO
DO
DO
DO
"}
