"aS" = (/obj/machinery/atmospherics/pipe/simple/cyan/visible{dir = 9},/obj/machinery/meter,/turf/open/floor/engine,/area/engine/engineering)
"be" = (/obj/effect/turf_decal/stripes/line{dir = 4},/obj/machinery/atmospherics/components/binary/volume_pump{dir = 4},/obj/machinery/atmospherics/pipe/simple/scrubbers/hidden,/obj/machinery/light{dir = 4},/turf/open/floor/engine,/area/engine/engineering)
"by" = (/obj/structure/sign/warning/electricshock,/turf/closed/wall/r_wall,/area/engine/supermatter)
"cq" = (/obj/effect/turf_decal/stripes/line{dir = 2},/obj/machinery/camera/emp_proof{dir = 10; icon_state = "camera"},/turf/open/floor/engine,/area/engine/engineering)
"cI" = (/obj/structure/window/plasma/reinforced{dir = 4},/obj/machinery/power/rad_collector/anchored,/obj/structure/cable,/obj/machinery/atmospherics/pipe/manifold/general/visible{dir = 8},/turf/open/floor/engine,/area/engine/supermatter)
"dm" = (/obj/machinery/atmospherics/pipe/simple/cyan/visible{dir = 4},/obj/machinery/atmospherics/pipe/simple/scrubbers/visible,/turf/open/floor/engine,/area/engine/engineering)
"dP" = (/obj/machinery/atmospherics/pipe/simple/general/visible{dir = 9},/turf/closed/wall/r_wall,/area/engine/supermatter)
"en" = (/obj/effect/turf_decal/stripes/line{dir = 2},/obj/machinery/atmospherics/pipe/simple/scrubbers/visible{dir = 9},/obj/machinery/meter,/turf/open/floor/engine,/area/engine/engineering)
"hm" = (/obj/machinery/atmospherics/pipe/simple/cyan/visible,/obj/machinery/door/poddoor/shutters/preopen{id = "engsm"; name = "Radiation Chamber Shutters"},/turf/open/floor/plating,/area/engine/supermatter)
"ik" = (/obj/machinery/atmospherics/components/binary/volume_pump,/turf/open/floor/engine,/area/engine/supermatter)
"in" = (/obj/machinery/atmospherics/pipe/simple/general/visible{dir = 5},/turf/closed/wall/r_wall,/area/engine/supermatter)
"iM" = (/obj/machinery/atmospherics/pipe/simple/orange/visible/layer3,/turf/open/floor/engine,/area/engine/engineering)
"jt" = (/obj/effect/turf_decal/stripes/line{dir = 1},/obj/machinery/atmospherics/pipe/simple/scrubbers/visible{dir = 6},/turf/open/floor/engine,/area/engine/engineering)
"ju" = (/obj/effect/spawner/structure/window/plasma/reinforced,/turf/open/floor/engine,/area/engine/supermatter)
"jG" = (/obj/effect/turf_decal/stripes/line{dir = 1},/obj/machinery/power/emitter/anchored{dir = 4; state = 2},/obj/structure/cable,/turf/open/floor/engine,/area/engine/engineering)
"kj" = (/obj/structure/cable/layer1,/obj/structure/cable,/turf/open/floor/engine,/area/engine/engineering)
"ku" = (/obj/machinery/power/emitter/anchored{dir = 4; state = 2},/obj/structure/cable,/turf/open/floor/engine,/area/engine/engineering)
"kO" = (/obj/machinery/atmospherics/pipe/simple/cyan/visible{dir = 6},/turf/open/floor/engine,/area/engine/engineering)
"kW" = (/obj/machinery/door/airlock/engineering/glass/critical{heat_proof = 1; name = "Supermatter Chamber"; req_access_txt = "10"},/turf/open/floor/engine,/area/engine/supermatter)
"ld" = (/obj/machinery/power/supermatter_crystal/engine,/turf/open/floor/engine,/area/engine/supermatter)
"lz" = (/obj/structure/cable/layer1,/obj/machinery/atmospherics/pipe/simple/scrubbers/visible,/turf/open/floor/engine,/area/engine/engineering)
"mo" = (/obj/structure/reflector/single/anchored{dir = 9},/turf/open/floor/engine,/area/engine/engineering)
"mO" = (/obj/machinery/atmospherics/pipe/simple/cyan/visible{dir = 5},/turf/closed/wall/r_wall,/area/engine/supermatter)
"nh" = (/obj/effect/turf_decal/stripes/line{dir = 6},/obj/machinery/atmospherics/components/unary/vent_scrubber/on{dir = 1},/turf/open/floor/engine,/area/engine/engineering)
"nr" = (/obj/effect/turf_decal/stripes/line{dir = 9},/obj/structure/disposalpipe/segment{dir = 10},/obj/machinery/camera/emp_proof{c_tag = "Engine Containment Starboard Fore"; dir = 2; network = list("engine")},/turf/open/floor/engine,/area/engine/engineering)
"oV" = (/obj/structure/window/plasma/reinforced{dir = 4},/obj/machinery/power/rad_collector/anchored,/obj/structure/cable,/obj/structure/cable,/obj/machinery/atmospherics/pipe/manifold/general/visible{dir = 8},/turf/open/floor/engine,/area/engine/supermatter)
"pj" = (/obj/effect/turf_decal/stripes/line{dir = 2},/obj/machinery/atmospherics/pipe/simple/scrubbers/visible{dir = 4},/obj/machinery/airalarm{dir = 1; pixel_y = -22},/turf/open/floor/engine,/area/engine/engineering)
"pB" = (/obj/machinery/atmospherics/pipe/manifold/general/visible,/turf/open/floor/engine,/area/engine/engineering)
"pP" = (/obj/machinery/atmospherics/pipe/simple/general/visible{dir = 10},/turf/closed/wall/r_wall,/area/engine/supermatter)
"qE" = (/obj/machinery/atmospherics/components/trinary/filter/flipped/critical{filter_type = "n2"},/turf/open/floor/engine,/area/engine/engineering)
"qI" = (/obj/effect/turf_decal/stripes/line{dir = 1},/obj/structure/cable,/turf/open/floor/engine,/area/engine/engineering)
"rt" = (/obj/effect/turf_decal/stripes/line{dir = 1},/obj/machinery/firealarm{pixel_y = 32},/obj/machinery/light{dir = 1},/turf/open/floor/engine,/area/engine/engineering)
"rS" = (/obj/effect/turf_decal/stripes/line{dir = 8},/obj/structure/disposalpipe/trunk{dir = 1},/obj/structure/disposaloutlet{dir = 4},/turf/open/floor/engine,/area/engine/engineering)
"st" = (/obj/machinery/atmospherics/components/unary/vent_pump/on{dir = 4},/turf/open/floor/engine,/area/engine/supermatter)
"sI" = (/obj/structure/cable/layer1,/obj/structure/cable/layer1,/turf/open/floor/engine,/area/engine/engineering)
"sR" = (/obj/effect/turf_decal/stripes/line{dir = 8},/obj/structure/table,/obj/item/clothing/glasses/meson{pixel_x = 3; pixel_y = -1},/turf/open/floor/engine,/area/engine/engineering)
"tk" = (/obj/machinery/atmospherics/components/binary/volume_pump{dir = 4},/turf/open/floor/engine,/area/engine/engineering)
"tn" = (/obj/structure/window/plasma/reinforced{dir = 8},/obj/machinery/power/rad_collector/anchored,/obj/structure/cable,/obj/machinery/atmospherics/pipe/simple/general/visible{dir = 10},/turf/open/floor/engine,/area/engine/supermatter)
"uX" = (/obj/machinery/camera/emp_proof{c_tag = "Engine Containment Starboard Fore"; dir = 2; network = list("engine")},/turf/open/floor/engine,/area/engine/supermatter)
"va" = (/obj/effect/turf_decal/stripes/line{dir = 2},/turf/open/floor/engine,/area/engine/engineering)
"vB" = (/obj/machinery/atmospherics/pipe/simple/general/visible{dir = 5},/turf/open/floor/engine,/area/engine/engineering)
"vU" = (/obj/effect/turf_decal/stripes/line{dir = 10},/obj/structure/reagent_dispensers/fueltank,/turf/open/floor/engine,/area/engine/engineering)
"wi" = (/obj/structure/cable/layer1,/obj/machinery/atmospherics/pipe/simple/cyan/visible,/turf/open/floor/engine,/area/engine/engineering)
"wl" = (/obj/machinery/atmospherics/components/trinary/filter/flipped/critical,/turf/open/floor/engine,/area/engine/engineering)
"wq" = (/obj/machinery/atmospherics/pipe/simple/cyan/visible{dir = 4},/turf/open/floor/engine,/area/engine/engineering)
"wR" = (/obj/machinery/atmospherics/pipe/simple/cyan/visible{dir = 4},/turf/closed/wall/r_wall,/area/engine/supermatter)
"yd" = (/obj/machinery/atmospherics/pipe/simple/general/visible,/turf/open/floor/engine,/area/engine/engineering)
"yy" = (/obj/effect/turf_decal/stripes/line{dir = 2},/obj/machinery/atmospherics/pipe/simple/scrubbers/visible{dir = 4},/obj/machinery/light{light_color = "#cee5d2"},/turf/open/floor/engine,/area/engine/engineering)
"AP" = (/obj/machinery/atmospherics/pipe/simple/green/visible,/turf/closed/wall/r_wall,/area/engine/supermatter)
"Bn" = (/obj/structure/sign/warning/fire,/turf/closed/wall/r_wall,/area/engine/supermatter)
"Br" = (/obj/machinery/atmospherics/pipe/simple/orange/visible{dir = 5},/turf/open/floor/engine,/area/engine/engineering)
"BQ" = (/obj/structure/cable/multilayer{cable_layer = 3},/obj/machinery/atmospherics/pipe/simple/cyan/visible,/obj/machinery/door/poddoor/shutters/preopen{id = "engsm"; name = "Radiation Chamber Shutters"},/turf/open/floor/plating,/area/engine/supermatter)
"Ck" = (/obj/effect/turf_decal/stripes/line{dir = 4},/obj/machinery/atmospherics/pipe/simple/scrubbers/hidden{dir = 6},/turf/open/floor/engine,/area/engine/engineering)
"CN" = (/obj/effect/turf_decal/stripes/line{dir = 4},/obj/machinery/atmospherics/pipe/simple/scrubbers/hidden,/turf/open/floor/engine,/area/engine/engineering)
"CO" = (/obj/effect/turf_decal/stripes/line{dir = 2},/obj/machinery/atmospherics/pipe/simple/scrubbers/visible{dir = 4},/turf/open/floor/engine,/area/engine/engineering)
"CU" = (/obj/effect/turf_decal/stripes/line{dir = 5},/obj/machinery/atmospherics/pipe/layer_manifold/visible{dir = 4},/obj/machinery/camera/emp_proof{c_tag = "Engine Containment Starboard Fore"; dir = 2; network = list("engine")},/turf/open/floor/engine,/area/engine/engineering)
"Dj" = (/obj/machinery/atmospherics/components/binary/volume_pump{dir = 1},/obj/item/radio/intercom{pixel_y = 21},/obj/machinery/airalarm/engine{dir = 8; pixel_x = 24},/turf/open/floor/engine,/area/engine/supermatter)
"Dr" = (/obj/item/radio/intercom{pixel_y = 21},/obj/machinery/computer/atmos_control/tank/sm{dir = 4},/turf/open/floor/engine,/area/engine/engineering)
"FF" = (/obj/structure/cable/layer1,/obj/machinery/button/door{id = "engsm"; name = "Radiation Shutters Control"; pixel_x = 24; req_access_txt = "10"},/obj/machinery/light{dir = 4},/turf/open/floor/engine,/area/engine/engineering)
"FM" = (/obj/effect/turf_decal/stripes/line{dir = 1},/obj/structure/reflector/box/anchored,/obj/structure/cable/layer1,/obj/structure/cable,/obj/structure/cable,/obj/structure/cable,/turf/open/floor/engine,/area/engine/engineering)
"Gi" = (/obj/structure/cable/layer1,/obj/machinery/atmospherics/pipe/simple/scrubbers/visible,/obj/machinery/light{dir = 8},/turf/open/floor/engine,/area/engine/engineering)
"GN" = (/obj/effect/turf_decal/stripes/line{dir = 8},/turf/open/floor/engine,/area/engine/engineering)
"Hh" = (/obj/machinery/atmospherics/pipe/manifold/supply/hidden{dir = 8},/turf/open/floor/engine,/area/engine/engineering)
"Ir" = (/obj/structure/cable/layer1,/obj/machinery/light{light_color = "#cee5d2"},/turf/open/floor/engine,/area/engine/engineering)
"Jd" = (/obj/machinery/atmospherics/pipe/simple/green/visible{dir = 4},/obj/machinery/atmospherics/pipe/simple/scrubbers/visible,/turf/open/floor/engine,/area/engine/engineering)
"JF" = (/obj/machinery/atmospherics/components/binary/volume_pump,/turf/open/floor/engine,/area/engine/engineering)
"Ku" = (/obj/machinery/atmospherics/components/unary/vent_pump/on{dir = 8},/turf/open/floor/engine,/area/engine/engineering)
"KL" = (/obj/structure/cable,/turf/open/floor/engine,/area/engine/supermatter)
"KN" = (/obj/machinery/atmospherics/pipe/simple/general/visible{dir = 6},/turf/closed/wall/r_wall,/area/engine/supermatter)
"La" = (/obj/machinery/atmospherics/components/binary/volume_pump,/obj/machinery/light{dir = 8},/turf/open/floor/engine,/area/engine/engineering)
"Lb" = (/obj/machinery/atmospherics/pipe/simple/cyan/visible,/turf/closed/wall/r_wall,/area/engine/supermatter)
"Li" = (/obj/structure/cable/multilayer{cable_layer = 3},/obj/machinery/door/poddoor/shutters/preopen{id = "engsm"; name = "Radiation Chamber Shutters"},/turf/open/floor/plating,/area/engine/supermatter)
"Lo" = (/obj/machinery/atmospherics/components/unary/vent_pump/on{dir = 1},/turf/open/floor/engine,/area/engine/engineering)
"LB" = (/obj/machinery/atmospherics/pipe/manifold/green/visible{dir = 1},/turf/open/floor/engine,/area/engine/engineering)
"LJ" = (/obj/machinery/atmospherics/pipe/simple/green/visible{dir = 4},/obj/machinery/light{dir = 1},/turf/open/floor/engine,/area/engine/engineering)
"LK" = (/obj/effect/turf_decal/stripes/line{dir = 8},/obj/structure/table,/obj/item/clothing/glasses/meson{pixel_x = -4; pixel_y = 6},/obj/item/stack/cable_coil{pixel_x = 3; pixel_y = -7},/turf/open/floor/engine,/area/engine/engineering)
"LP" = (/obj/structure/cable/layer1,/turf/open/floor/engine,/area/engine/engineering)
"Mb" = (/obj/machinery/atmospherics/pipe/simple/supply/hidden,/turf/open/floor/engine,/area/engine/engineering)
"Mn" = (/obj/machinery/atmospherics/pipe/layer_manifold/visible,/turf/open/floor/engine,/area/engine/engineering)
"MG" = (/turf/open/floor/engine,/area/engine/supermatter)
"Nl" = (/obj/machinery/atmospherics/pipe/simple/cyan/visible{dir = 5},/obj/machinery/atmospherics/pipe/simple/orange/visible/layer3,/turf/open/floor/engine,/area/engine/engineering)
"Nx" = (/obj/effect/turf_decal/stripes/line{dir = 1},/obj/machinery/atmospherics/pipe/simple/supply/hidden,/turf/open/floor/engine,/area/engine/engineering)
"Nz" = (/obj/machinery/atmospherics/components/unary/vent_scrubber/on{dir = 4},/turf/open/floor/engine,/area/engine/engineering)
"Og" = (/obj/machinery/atmospherics/components/unary/portables_connector/visible,/obj/machinery/portable_atmospherics/canister/nitrogen,/turf/open/floor/engine,/area/engine/engineering)
"Oj" = (/obj/effect/turf_decal/stripes/line{dir = 1},/obj/machinery/atmospherics/pipe/simple/scrubbers/visible{dir = 4},/obj/machinery/atmospherics/pipe/simple/orange/visible/layer3{dir = 6},/obj/machinery/firealarm{pixel_y = 32},/obj/machinery/light{dir = 1},/turf/open/floor/engine,/area/engine/engineering)
"OK" = (/obj/machinery/atmospherics/components/unary/vent_scrubber/on{dir = 8},/turf/open/floor/engine,/area/engine/supermatter)
"PA" = (/obj/effect/turf_decal/stripes/line{dir = 1},/obj/machinery/atmospherics/pipe/simple/scrubbers/visible{dir = 10},/obj/machinery/atmospherics/pipe/simple/orange/visible/layer3{dir = 4},/turf/open/floor/engine,/area/engine/engineering)
"PQ" = (/obj/machinery/light{dir = 4},/turf/open/floor/engine,/area/engine/engineering)
"PX" = (/obj/effect/turf_decal/stripes/line{dir = 4},/obj/machinery/atmospherics/pipe/manifold/scrubbers/hidden{dir = 4},/turf/open/floor/engine,/area/engine/engineering)
"PY" = (/obj/structure/window/plasma/reinforced{dir = 4},/obj/machinery/power/rad_collector/anchored,/obj/structure/cable,/obj/machinery/atmospherics/pipe/simple/general/visible{dir = 6},/turf/open/floor/engine,/area/engine/supermatter)
"QY" = (/obj/effect/turf_decal/stripes/line{dir = 4},/obj/machinery/atmospherics/pipe/simple/scrubbers/hidden,/obj/machinery/light{dir = 4},/turf/open/floor/engine,/area/engine/engineering)
"Rc" = (/obj/effect/turf_decal/stripes/line{dir = 1},/obj/machinery/power/emitter/anchored{dir = 8; state = 2},/obj/structure/cable,/obj/structure/cable,/turf/open/floor/engine,/area/engine/engineering)
"RU" = (/obj/effect/turf_decal/stripes/line{dir = 8},/obj/structure/table,/obj/item/clothing/glasses/meson{pixel_y = 7},/turf/open/floor/engine,/area/engine/engineering)
"Sm" = (/obj/structure/cable/layer1,/obj/structure/cable/layer1,/obj/machinery/atmospherics/pipe/simple/scrubbers/visible,/turf/open/floor/engine,/area/engine/engineering)
"SC" = (/obj/machinery/atmospherics/pipe/simple/green/visible{dir = 9},/turf/open/floor/engine,/area/engine/engineering)
"Tq" = (/obj/effect/turf_decal/stripes/line{dir = 8},/obj/structure/closet/secure_closet/engineering_electrical,/turf/open/floor/engine,/area/engine/engineering)
"Tz" = (/obj/effect/turf_decal/stripes/line{dir = 8},/obj/machinery/light{dir = 8},/turf/open/floor/engine,/area/engine/engineering)
"TG" = (/turf/closed/wall/r_wall,/area/engine/supermatter)
"Ud" = (/obj/machinery/atmospherics/pipe/simple/scrubbers/visible,/turf/open/floor/engine,/area/engine/engineering)
"UA" = (/obj/machinery/atmospherics/pipe/simple/cyan/visible,/obj/machinery/firealarm{pixel_y = 32},/turf/open/floor/engine,/area/engine/engineering)
"UD" = (/obj/structure/cable,/turf/open/floor/engine,/area/engine/engineering)
"UK" = (/obj/machinery/meter,/obj/machinery/atmospherics/pipe/manifold/green/visible,/turf/open/floor/engine,/area/engine/engineering)
"UV" = (/obj/machinery/door/poddoor/shutters/preopen{id = "engsm"; name = "Radiation Chamber Shutters"},/turf/open/floor/plating,/area/engine/supermatter)
"Vr" = (/obj/effect/turf_decal/stripes/line{dir = 1},/turf/open/floor/engine,/area/engine/engineering)
"VU" = (/obj/machinery/atmospherics/pipe/manifold/cyan/visible{dir = 1},/obj/machinery/atmospherics/pipe/simple/orange/visible/layer3,/turf/open/floor/engine,/area/engine/engineering)
"VX" = (/turf/open/floor/engine,/area/engine/engineering)
"XR" = (/obj/machinery/atmospherics/pipe/simple/green/visible{dir = 4},/turf/open/floor/engine,/area/engine/engineering)
"Yk" = (/obj/structure/window/plasma/reinforced{dir = 8},/obj/machinery/power/rad_collector/anchored,/obj/structure/cable,/obj/machinery/atmospherics/pipe/manifold/general/visible{dir = 4},/turf/open/floor/engine,/area/engine/supermatter)
"YG" = (/obj/effect/turf_decal/stripes/line{dir = 4},/obj/machinery/atmospherics/components/binary/volume_pump{dir = 8},/obj/machinery/atmospherics/pipe/simple/scrubbers/hidden,/turf/open/floor/engine,/area/engine/engineering)
"YM" = (/obj/machinery/atmospherics/pipe/manifold/cyan/visible{dir = 8},/obj/machinery/atmospherics/pipe/simple/orange/visible/layer3,/turf/open/floor/engine,/area/engine/engineering)
"Zz" = (/obj/effect/turf_decal/stripes/line{dir = 2},/obj/machinery/atmospherics/pipe/simple/scrubbers/visible{dir = 6},/obj/machinery/light{light_color = "#cee5d2"},/turf/open/floor/engine,/area/engine/engineering)

(1,1,1) = {"
nrNxrtVrVrjGqIqIFMqIqIRcVrjtOjPACU
rSHhKuVXVXkuVXmoLPVXVXUDkOdmVUwlCk
TzMbVXLPLPkjLPLPsIIrLPkjwiSmYMwlQY
TqMbVXFFTGTGTGbyjuBnTGTGLbGiNlqECN
sRMbVXLPUVMGPYOKMGsttnuXhmlziMBrYG
LKMbVXLPLiKLoVOKldstYkKLBQlziMNzPX
RUMbVXVXUVMGcIOKMGstYkMGhmUdiMVXCN
TqMbVXPQTGTGinpPkWKNdPTGLbLaMnVXCN
TzMbVXVXOgOgTGikMGDjTGDrUAUdJFVXCN
GNMbVXVXydydTGAPkWmOwRwqaSUdBrLBbe
GNLoVXVXvBpBtkUKXRLJXRXRXRJdXRSCCN
vUvacqvaZzCOCOCOCOpjCOCOyyenvacqnh
"}
