"aL" = (/obj/machinery/atmospherics/pipe/simple/orange/visible{dir = 9},/turf/open/floor/engine,/area/space)
"bx" = (/obj/machinery/atmospherics/pipe/simple/supply/hidden/layer1{dir = 8},/obj/machinery/atmospherics/pipe/simple/scrubbers/hidden{dir = 4},/obj/machinery/button/door{id = "burnrelease"; name = "Burn Chamber Release Shutters Control"; pixel_y = -24; req_access_txt = "10"},/turf/open/floor/engine,/area/space)
"cg" = (/obj/machinery/atmospherics/pipe/simple/supply/hidden,/turf/open/floor/engine,/area/space)
"da" = (/obj/machinery/atmospherics/pipe/simple/purple,/turf/open/floor/engine,/area/space)
"dx" = (/obj/machinery/atmospherics/components/unary/vent_scrubber/on{dir = 1},/turf/open/floor/engine,/area/space)
"eh" = (/obj/machinery/atmospherics/pipe/simple/scrubbers/hidden,/obj/machinery/atmospherics/pipe/simple/cyan/visible{dir = 4},/turf/open/floor/engine,/area/space)
"eH" = (/obj/machinery/atmospherics/pipe/simple/scrubbers/hidden{dir = 4},/obj/machinery/atmospherics/pipe/simple/dark,/turf/open/floor/engine,/area/space)
"eR" = (/obj/machinery/atmospherics/pipe/simple/cyan/visible{dir = 4},/turf/open/floor/engine,/area/space)
"eX" = (/obj/machinery/atmospherics/pipe/manifold4w/orange/visible,/turf/open/floor/engine,/area/space)
"gc" = (/obj/machinery/atmospherics/pipe/simple/dark{dir = 9},/turf/open/floor/engine,/area/space)
"gg" = (/obj/machinery/atmospherics/pipe/simple/cyan/visible{dir = 4},/obj/effect/turf_decal/arrows{dir = 8; pixel_y = 9},/obj/effect/turf_decal/loading_area{dir = 1; pixel_y = -11},/turf/open/floor/engine,/area/space)
"gT" = (/obj/machinery/atmospherics/pipe/simple/scrubbers/hidden,/turf/open/floor/engine,/area/space)
"hl" = (/obj/machinery/atmospherics/pipe/simple/supply/hidden/layer1{dir = 8},/obj/machinery/atmospherics/pipe/simple/scrubbers/hidden{dir = 4},/obj/effect/spawner/structure/window/plasma/reinforced,/obj/machinery/door/poddoor/shutters/preopen{id = "burnchamb"},/turf/open/floor/engine,/area/space)
"iu" = (/obj/machinery/atmospherics/pipe/simple/orange/visible{dir = 6},/turf/open/floor/engine,/area/space)
"jl" = (/obj/structure/disposalpipe/segment,/obj/machinery/atmospherics/pipe/simple/dark{dir = 4},/turf/open/floor/engine,/area/space)
"jw" = (/obj/machinery/portable_atmospherics/canister/nitrous_oxide,/obj/effect/turf_decal/delivery,/obj/machinery/atmospherics/pipe/simple/dark,/turf/open/floor/engine,/area/space)
"kj" = (/obj/machinery/atmospherics/components/unary/vent_pump/on/layer1,/obj/machinery/atmospherics/pipe/simple/dark,/turf/open/floor/engine,/area/space)
"kq" = (/obj/machinery/atmospherics/components/binary/circulator{dir = 4; icon_state = "circ-off-0"},/turf/open/floor/engine,/area/space)
"kL" = (/obj/machinery/atmospherics/components/unary/vent_pump/on/layer1{dir = 1},/turf/open/floor/engine,/area/space)
"lG" = (/obj/machinery/atmospherics/components/binary/circulator/cold{dir = 8; icon_state = "circ-off-0"},/turf/open/floor/engine,/area/space)
"mo" = (/obj/machinery/atmospherics/pipe/simple/dark,/turf/open/floor/engine,/area/space)
"mB" = (/obj/machinery/atmospherics/pipe/simple/purple{dir = 8},/turf/open/floor/engine,/area/space)
"mI" = (/obj/machinery/door/poddoor{id = "burnrelease"},/obj/machinery/atmospherics/pipe/simple/dark{dir = 4},/turf/open/floor/engine,/area/space)
"pu" = (/obj/machinery/atmospherics/pipe/heat_exchanging/simple{dir = 9},/obj/machinery/atmospherics/pipe/simple/dark{dir = 4},/turf/open/floor/engine,/area/space)
"pQ" = (/obj/machinery/atmospherics/pipe/layer_manifold,/turf/open/floor/engine,/area/space)
"pX" = (/obj/machinery/atmospherics/pipe/simple/cyan/visible{dir = 5},/obj/effect/turf_decal/loading_area{dir = 8},/turf/open/floor/engine,/area/space)
"rA" = (/obj/machinery/atmospherics/components/binary/volume_pump,/turf/open/floor/engine,/area/space)
"rE" = (/obj/machinery/light{dir = 8; light_color = "#e8eaff"},/turf/open/floor/engine,/area/space)
"rY" = (/obj/machinery/atmospherics/pipe/simple/supply/hidden/layer1{dir = 8},/obj/machinery/atmospherics/pipe/simple/scrubbers/hidden{dir = 4},/turf/open/floor/engine,/area/space)
"sb" = (/obj/machinery/atmospherics/pipe/simple/cyan/visible{dir = 4},/obj/machinery/atmospherics/pipe/simple/dark,/turf/open/floor/engine,/area/space)
"st" = (/obj/effect/spawner/structure/window/plasma/reinforced,/obj/machinery/door/poddoor/shutters/preopen{id = "burnchamb"},/turf/open/floor/engine,/area/space)
"sz" = (/obj/structure/sign/warning/fire,/turf/closed/wall/r_wall,/area/space)
"sI" = (/obj/machinery/atmospherics/pipe/manifold/scrubbers/hidden{dir = 1},/turf/open/floor/engine,/area/space)
"uc" = (/obj/effect/spawner/structure/window/plasma/reinforced,/obj/machinery/door/poddoor/shutters/preopen{id = "burnchamb"},/obj/machinery/atmospherics/pipe/simple/dark{dir = 4},/turf/open/floor/engine,/area/space)
"ux" = (/obj/machinery/atmospherics/components/unary/portables_connector/visible{dir = 4},/obj/machinery/portable_atmospherics/canister/nitrous_oxide,/obj/effect/turf_decal/box/red,/turf/open/floor/engine,/area/space)
"uJ" = (/obj/structure/disposalpipe/segment{dir = 10},/turf/open/floor/engine,/area/space)
"vd" = (/obj/machinery/atmospherics/pipe/manifold4w/scrubbers/hidden,/turf/open/floor/engine,/area/space)
"vG" = (/obj/machinery/atmospherics/pipe/heat_exchanging/simple{dir = 8},/obj/machinery/atmospherics/components/unary/outlet_injector/on{dir = 4},/turf/open/floor/engine,/area/space)
"vP" = (/obj/machinery/portable_atmospherics/canister/toxins,/obj/effect/turf_decal/box,/turf/open/floor/engine,/area/space)
"wi" = (/obj/machinery/atmospherics/pipe/simple/supply/hidden/layer1{dir = 8},/obj/machinery/atmospherics/pipe/manifold/scrubbers/hidden,/turf/open/floor/engine,/area/space)
"wk" = (/obj/machinery/atmospherics/pipe/simple/cyan/visible{dir = 5},/obj/machinery/camera/emp_proof{dir = 4; icon_state = "camera"},/turf/open/floor/engine,/area/space)
"ws" = (/obj/structure/cable/layer1,/turf/open/floor/engine,/area/space)
"wA" = (/obj/machinery/atmospherics/pipe/simple/supply/hidden/layer1{dir = 8},/obj/machinery/atmospherics/pipe/simple/scrubbers/hidden{dir = 4},/obj/machinery/atmospherics/pipe/heat_exchanging/simple,/turf/open/floor/engine,/area/space)
"wI" = (/obj/machinery/atmospherics/pipe/simple/supply/hidden/layer1,/turf/open/floor/engine,/area/space)
"xQ" = (/obj/machinery/atmospherics/components/unary/portables_connector/visible,/obj/machinery/portable_atmospherics/canister/nitrous_oxide,/obj/effect/turf_decal/box/red,/turf/open/floor/engine,/area/space)
"yJ" = (/obj/machinery/atmospherics/pipe/simple/cyan/visible{dir = 4},/obj/effect/turf_decal/arrows{dir = 8; pixel_y = 9},/obj/machinery/atmospherics/pipe/simple/dark,/obj/effect/turf_decal/loading_area{dir = 1; pixel_y = -11},/turf/open/floor/engine,/area/space)
"zm" = (/obj/machinery/atmospherics/pipe/simple/supply/hidden/layer1{dir = 9},/obj/machinery/atmospherics/pipe/simple/scrubbers/hidden{dir = 4},/obj/machinery/atmospherics/pipe/simple/dark,/turf/open/floor/engine,/area/space)
"zN" = (/obj/machinery/atmospherics/pipe/manifold/supply/hidden/layer1{dir = 1},/obj/machinery/atmospherics/components/unary/vent_scrubber/on{dir = 4},/turf/open/floor/engine,/area/space)
"CF" = (/obj/machinery/atmospherics/components/binary/volume_pump,/obj/machinery/light{dir = 4},/turf/open/floor/engine,/area/space)
"CP" = (/obj/machinery/atmospherics/pipe/manifold/cyan/visible{dir = 1},/obj/effect/turf_decal/arrows{dir = 8; pixel_y = 9},/turf/open/floor/engine,/area/space)
"Ds" = (/obj/machinery/atmospherics/pipe/simple/scrubbers/hidden,/obj/machinery/atmospherics/pipe/simple/dark{dir = 4},/turf/open/floor/engine,/area/space)
"Du" = (/obj/machinery/camera/emp_proof{c_tag = "Engine Containment Starboard Fore"; dir = 2; network = list("engine")},/obj/machinery/atmospherics/pipe/simple/dark{dir = 6},/obj/machinery/light{dir = 1},/turf/open/floor/engine,/area/space)
"Dx" = (/obj/structure/lattice,/obj/machinery/atmospherics/pipe/simple/dark{dir = 4},/turf/open/space/basic,/area/space)
"Dz" = (/obj/machinery/atmospherics/pipe/simple/cyan/visible{dir = 10},/turf/open/floor/engine,/area/space)
"Em" = (/obj/machinery/atmospherics/pipe/simple/purple{dir = 6},/turf/open/floor/engine,/area/space)
"ER" = (/obj/machinery/light{dir = 4},/turf/open/floor/engine,/area/space)
"FM" = (/obj/machinery/power/generator,/obj/structure/cable,/turf/open/floor/engine,/area/space)
"Ga" = (/obj/machinery/atmospherics/pipe/simple/cyan/visible{dir = 9},/turf/open/floor/engine,/area/space)
"Gg" = (/obj/machinery/atmospherics/pipe/simple/orange/visible{dir = 4},/turf/open/floor/engine,/area/space)
"Gj" = (/obj/machinery/atmospherics/pipe/simple/orange/visible{dir = 10},/turf/open/floor/engine,/area/space)
"Gw" = (/obj/structure/cable/multilayer{cable_layer = 3},/turf/open/floor/engine,/area/space)
"GB" = (/obj/structure/disposalpipe/trunk{dir = 1},/obj/structure/disposaloutlet{dir = 4},/turf/open/floor/engine,/area/space)
"Hz" = (/obj/effect/spawner/structure/window/plasma/reinforced,/obj/machinery/door/poddoor/shutters/preopen{id = "burnchamb"},/obj/machinery/atmospherics/pipe/heat_exchanging/junction,/turf/open/floor/engine,/area/space)
"IS" = (/obj/machinery/atmospherics/pipe/simple/supply/hidden/layer1{dir = 8},/turf/open/floor/engine,/area/space)
"IY" = (/obj/machinery/atmospherics/pipe/simple/scrubbers/hidden{dir = 9},/turf/open/floor/engine,/area/space)
"Ja" = (/obj/machinery/atmospherics/pipe/simple/supply/hidden/layer1{dir = 8},/obj/machinery/atmospherics/pipe/simple/scrubbers/hidden{dir = 4},/obj/structure/cable/layer1,/turf/open/floor/engine,/area/space)
"Jp" = (/obj/machinery/atmospherics/pipe/simple/supply/hidden/layer1{dir = 8},/obj/machinery/atmospherics/components/unary/vent_scrubber/on{dir = 4},/turf/open/floor/engine,/area/space)
"Jx" = (/obj/machinery/atmospherics/pipe/heat_exchanging/simple,/obj/machinery/atmospherics/pipe/simple/purple{dir = 8},/turf/open/floor/engine,/area/space)
"JW" = (/obj/machinery/atmospherics/pipe/simple/cyan/visible{dir = 6},/turf/open/floor/engine,/area/space)
"Ki" = (/obj/machinery/atmospherics/pipe/heat_exchanging/simple{dir = 5},/turf/open/floor/engine,/area/space)
"KG" = (/obj/effect/spawner/structure/window/plasma/reinforced,/obj/effect/spawner/structure/window/plasma/reinforced,/obj/machinery/door/poddoor/shutters/preopen{id = "burnchamb"},/obj/machinery/atmospherics/pipe/simple/purple{dir = 8},/turf/open/floor/engine,/area/space)
"KI" = (/obj/machinery/atmospherics/components/binary/volume_pump{dir = 8},/turf/open/floor/engine,/area/space)
"Ld" = (/obj/machinery/atmospherics/pipe/heat_exchanging/simple{dir = 5},/obj/machinery/atmospherics/components/unary/vent_scrubber/on{dir = 8},/turf/open/floor/engine,/area/space)
"Lf" = (/obj/machinery/atmospherics/pipe/simple/supply/hidden/layer1{dir = 5},/turf/open/floor/engine,/area/space)
"Lo" = (/turf/open/floor/engine,/area/space)
"Ml" = (/obj/machinery/atmospherics/components/unary/vent_scrubber/on,/turf/open/floor/engine,/area/space)
"Nb" = (/obj/machinery/portable_atmospherics/canister/nitrous_oxide,/obj/effect/turf_decal/delivery,/turf/open/floor/engine,/area/space)
"Ox" = (/obj/machinery/atmospherics/components/binary/volume_pump{dir = 1},/turf/open/floor/engine,/area/space)
"OX" = (/obj/machinery/atmospherics/pipe/simple/cyan/visible,/turf/open/floor/engine,/area/space)
"OZ" = (/obj/machinery/light{dir = 8},/turf/open/floor/engine,/area/space)
"Qc" = (/obj/machinery/atmospherics/pipe/simple/dark{dir = 4},/turf/open/floor/engine,/area/space)
"Qw" = (/obj/machinery/atmospherics/pipe/heat_exchanging/simple{dir = 10},/turf/open/floor/engine,/area/space)
"Rm" = (/obj/machinery/atmospherics/pipe/simple/supply/hidden/layer1{dir = 8},/obj/machinery/atmospherics/pipe/simple/scrubbers/hidden{dir = 4},/obj/machinery/atmospherics/pipe/heat_exchanging/simple{dir = 6},/obj/machinery/igniter{id = "burnigniter"; luminosity = 2},/turf/open/floor/engine,/area/space)
"Ro" = (/obj/machinery/atmospherics/pipe/simple/supply/hidden/layer1{dir = 8},/obj/machinery/atmospherics/pipe/simple/scrubbers/hidden{dir = 4},/obj/machinery/atmospherics/pipe/heat_exchanging/simple{dir = 9},/turf/open/floor/engine,/area/space)
"Rw" = (/obj/machinery/airalarm/all_access{dir = 1; pixel_y = -24},/obj/machinery/light,/obj/machinery/camera/emp_proof{c_tag = "Engineering Port Aft"; dir = 1},/obj/machinery/portable_atmospherics/canister/toxins,/obj/effect/turf_decal/box,/turf/open/floor/engine,/area/space)
"Rz" = (/obj/machinery/atmospherics/components/binary/volume_pump{dir = 4},/turf/open/floor/engine,/area/space)
"Sa" = (/obj/machinery/atmospherics/pipe/manifold/supply/hidden/layer1{dir = 8},/turf/open/floor/engine,/area/space)
"TX" = (/turf/closed/wall/r_wall,/area/space)
"Uw" = (/obj/machinery/camera/emp_proof{c_tag = "Engine Containment Starboard Fore"; dir = 2; network = list("engine")},/obj/machinery/light{dir = 1},/turf/open/floor/engine,/area/space)
"Ux" = (/obj/machinery/atmospherics/pipe/simple/cyan/visible{dir = 5},/obj/machinery/light,/obj/machinery/button/ignition{id = "burnigniter"; pixel_x = -6; pixel_y = -26},/turf/open/floor/engine,/area/space)
"UF" = (/obj/machinery/light{dir = 4; light_color = "#c1caff"},/turf/open/floor/engine,/area/space)
"UG" = (/obj/machinery/atmospherics/components/unary/vent_pump/on/layer1{dir = 8},/obj/machinery/atmospherics/pipe/simple/scrubbers/hidden{dir = 4},/turf/open/floor/engine,/area/space)
"Wv" = (/obj/machinery/atmospherics/pipe/simple/scrubbers/hidden{dir = 6},/obj/structure/disposalpipe/trunk{dir = 1},/obj/machinery/disposal/deliveryChute{dir = 8},/turf/open/floor/engine,/area/space)
"WT" = (/obj/machinery/atmospherics/pipe/manifold/orange/visible{dir = 4},/turf/open/floor/engine,/area/space)
"YX" = (/obj/machinery/atmospherics/pipe/simple/cyan/visible{dir = 5},/turf/open/floor/engine,/area/space)
"ZB" = (/obj/machinery/portable_atmospherics/canister/nitrogen,/obj/effect/turf_decal/box,/turf/open/floor/engine,/area/space)
"ZS" = (/obj/machinery/atmospherics/pipe/simple/orange/visible,/turf/open/floor/engine,/area/space)

(1,1,1) = {"
uJcgUwLoLoLoLoLowsLoLoLoLoLoDuDsjl
GBpQLoLoLoLoLoLowsLoLoLoLoLorAgTWv
LoSaISzNrYrYrYrYJaJaJarYUGsIeHvdIY
rEwILokLLoZBZBiuGgGjGwJWDzdxmogTER
LowILouxGjZBZBZSLokqFMlGYXeRsbehKI
LowILouxeXGgRzWTLoZSLoOXLoLomogTLo
LowILouxaLvPvPrALoZSxQpXCPggyJehDz
LowILoLoLovPRwZSLoOxUxDzOxNbjwgTOX
LowILoLoLoUFTXHzstHzTXwkGaMlkjgTOX
rELfJprYrYrYhlwARmRohlbxrYwizmIYCF
LoLoLoEmmBKIKGJxLdQwstTXszOZmoLoYX
LoLoLodaLoLostKivGpumIDxucQcgcLoLo
"}
