//MAP CONVERTED BY dmm2tgm.py THIS HEADER COMMENT PREVENTS RECONVERSION, DO NOT REMOVE
"aj" = (
/obj/effect/turf_decal/stripes/line{
	dir = 4
	},
/obj/machinery/atmospherics/pipe/simple/green/visible,
/turf/open/floor/engine,
/area/engine/engineering)
"ap" = (
/obj/effect/turf_decal/stripes/line{
	dir = 1
	},
/obj/structure/cable,
/obj/item/radio/intercom{
	pixel_y = 21
	},
/turf/open/floor/engine,
/area/engine/engineering)
"aG" = (
/obj/structure/cable,
/obj/effect/turf_decal/stripes/line{
	dir = 4
	},
/obj/machinery/atmospherics/pipe/simple/scrubbers/visible,
/turf/open/floor/engine,
/area/engine/engineering)
"aV" = (
/obj/effect/turf_decal/stripes/line,
/obj/machinery/atmospherics/components/binary/pump{
	dir = 8;
	name = "Mix Bypass"
	},
/turf/open/floor/engine,
/area/engine/engineering)
"bO" = (
/obj/effect/turf_decal/stripes/line,
/obj/structure/cable,
/obj/structure/cable/layer1,
/obj/machinery/atmospherics/components/binary/pump{
	dir = 1;
	name = "Atmos to Loop"
	},
/turf/open/floor/engine,
/area/engine/engineering)
"cU" = (
/obj/effect/turf_decal/stripes/line{
	dir = 4
	},
/obj/machinery/atmospherics/components/trinary/filter/flipped/critical,
/turf/open/floor/engine,
/area/engine/engineering)
"cW" = (
/obj/effect/turf_decal/stripes/line{
	dir = 4
	},
/obj/machinery/atmospherics/pipe/manifold/cyan/visible{
	dir = 8
	},
/turf/open/floor/engine,
/area/engine/engineering)
"ed" = (
/obj/machinery/power/supermatter_crystal/engine,
/turf/open/floor/engine,
/area/engine/supermatter)
"er" = (
/obj/structure/cable,
/obj/machinery/light{
	dir = 4
	},
/turf/open/floor/plating,
/area/engine/engineering)
"eQ" = (
/obj/structure/cable,
/obj/machinery/door/airlock/engineering/glass{
	name = "Laser Room";
	req_access_txt = "10"
	},
/obj/effect/turf_decal/stripes/line{
	dir = 8
	},
/obj/effect/turf_decal/stripes/line{
	dir = 4
	},
/obj/machinery/door/firedoor/border_only{
	dir = 4
	},
/obj/machinery/door/firedoor/border_only{
	dir = 8
	},
/turf/open/floor/plating,
/area/engine/engineering)
"fF" = (
/obj/effect/turf_decal/stripes/line{
	dir = 6
	},
/obj/machinery/atmospherics/pipe/simple/scrubbers/visible,
/turf/open/floor/engine,
/area/engine/engineering)
"gA" = (
/obj/structure/cable,
/obj/effect/turf_decal/stripes/corner{
	dir = 1
	},
/obj/machinery/atmospherics/pipe/simple/orange/visible{
	dir = 4
	},
/turf/open/floor/engine,
/area/engine/engineering)
"gR" = (
/obj/effect/turf_decal/stripes/corner,
/obj/machinery/atmospherics/pipe/simple/cyan/visible{
	dir = 6
	},
/turf/open/floor/engine,
/area/engine/engineering)
"hi" = (
/obj/effect/turf_decal/stripes/line{
	dir = 6
	},
/obj/machinery/atmospherics/components/binary/pump/on{
	dir = 1;
	name = "Gas to Cooling Loop"
	},
/turf/open/floor/engine,
/area/engine/engineering)
"jL" = (
/obj/effect/turf_decal/bot{
	dir = 1
	},
/obj/machinery/atmospherics/components/unary/portables_connector/visible{
	dir = 8
	},
/obj/machinery/portable_atmospherics/canister/nitrogen,
/turf/open/floor/plasteel/dark,
/area/engine/engineering)
"kJ" = (
/obj/effect/spawner/structure/window/plasma/reinforced,
/obj/machinery/door/firedoor/window,
/turf/open/floor/plating,
/area/engine/supermatter)
"lb" = (
/obj/effect/turf_decal/stripes/line{
	dir = 4
	},
/obj/machinery/light{
	dir = 4
	},
/obj/machinery/atmospherics/components/trinary/filter/flipped/critical,
/turf/open/floor/engine,
/area/engine/engineering)
"lW" = (
/obj/machinery/atmospherics/components/unary/vent_scrubber/on{
	dir = 1
	},
/obj/machinery/firealarm{
	pixel_y = 32
	},
/turf/open/floor/plasteel/dark,
/area/engine/engineering)
"md" = (
/obj/machinery/atmospherics/pipe/simple/cyan/visible{
	dir = 4
	},
/turf/closed/wall/r_wall,
/area/engine/supermatter)
"mi" = (
/obj/effect/turf_decal/stripes/line{
	dir = 1
	},
/obj/structure/cable,
/obj/machinery/atmospherics/components/binary/pump{
	dir = 1;
	name = "Mix to Gas"
	},
/turf/open/floor/engine,
/area/engine/engineering)
"mt" = (
/obj/effect/turf_decal/stripes/line,
/obj/structure/cable,
/obj/machinery/atmospherics/components/binary/pump/on{
	name = "Gas to Cooling Loop"
	},
/turf/open/floor/engine,
/area/engine/engineering)
"na" = (
/obj/machinery/atmospherics/components/unary/vent_pump/on,
/obj/machinery/airalarm{
	dir = 1;
	pixel_y = -22
	},
/turf/open/floor/plasteel/dark,
/area/engine/engineering)
"np" = (
/obj/machinery/atmospherics/pipe/simple/general/visible{
	dir = 5
	},
/turf/closed/wall/r_wall,
/area/engine/supermatter)
"nS" = (
/obj/machinery/door/poddoor/shutters/preopen{
	id = "engsm";
	name = "Radiation Chamber Shutters"
	},
/turf/open/floor/plating,
/area/engine/supermatter)
"nY" = (
/obj/effect/turf_decal/stripes/line,
/obj/machinery/camera{
	c_tag = "Engineering Supermatter Aft";
	dir = 1;
	network = list("ss13","engine")
	},
/obj/structure/cable,
/obj/structure/cable/layer1,
/turf/open/floor/engine,
/area/engine/engineering)
"pf" = (
/obj/structure/cable,
/obj/machinery/power/emitter/anchored{
	dir = 1;
	state = 2
	},
/turf/open/floor/plating,
/area/engine/engineering)
"po" = (
/obj/structure/reflector/double/anchored{
	dir = 5
	},
/turf/open/floor/plasteel/dark,
/area/engine/engineering)
"px" = (
/obj/machinery/atmospherics/components/binary/pump{
	dir = 8;
	name = "Gas to Filter"
	},
/turf/open/floor/engine,
/area/engine/supermatter)
"qp" = (
/obj/effect/turf_decal/delivery,
/obj/machinery/atmospherics/pipe/simple/scrubbers/visible{
	dir = 5
	},
/turf/open/floor/plasteel/dark,
/area/engine/engineering)
"qx" = (
/obj/effect/turf_decal/stripes/line{
	dir = 4
	},
/obj/machinery/atmospherics/pipe/simple/scrubbers/visible,
/turf/open/floor/engine,
/area/engine/engineering)
"qA" = (
/obj/effect/turf_decal/stripes/line,
/obj/structure/cable,
/turf/open/floor/engine,
/area/engine/engineering)
"qI" = (
/obj/effect/turf_decal/stripes/line{
	dir = 1
	},
/obj/structure/cable,
/obj/structure/cable/layer1,
/obj/machinery/atmospherics/components/unary/vent_scrubber/on{
	dir = 1
	},
/turf/open/floor/engine,
/area/engine/engineering)
"qN" = (
/obj/machinery/atmospherics/pipe/simple/general/visible{
	dir = 6
	},
/turf/closed/wall/r_wall,
/area/engine/supermatter)
"qQ" = (
/obj/effect/turf_decal/stripes/line{
	dir = 5
	},
/obj/machinery/meter,
/obj/machinery/atmospherics/pipe/simple/scrubbers/visible,
/turf/open/floor/engine,
/area/engine/engineering)
"rb" = (
/obj/structure/reflector/single/anchored{
	dir = 10
	},
/turf/open/floor/plating,
/area/engine/engineering)
"ri" = (
/obj/machinery/atmospherics/pipe/simple/general/visible{
	dir = 9
	},
/obj/machinery/meter,
/turf/closed/wall/r_wall,
/area/engine/supermatter)
"sf" = (
/obj/item/wrench,
/turf/open/floor/plasteel/dark,
/area/engine/engineering)
"tt" = (
/obj/effect/turf_decal/stripes/line,
/obj/machinery/meter,
/obj/machinery/light,
/obj/machinery/atmospherics/pipe/manifold/cyan/visible,
/turf/open/floor/engine,
/area/engine/engineering)
"tC" = (
/obj/effect/turf_decal/stripes/line,
/obj/machinery/light,
/obj/machinery/atmospherics/pipe/manifold/cyan/visible,
/obj/machinery/meter,
/turf/open/floor/engine,
/area/engine/engineering)
"uL" = (
/obj/effect/turf_decal/stripes/line{
	dir = 8
	},
/obj/machinery/atmospherics/pipe/simple/cyan/visible{
	dir = 5
	},
/turf/open/floor/engine,
/area/engine/engineering)
"vj" = (
/obj/structure/cable,
/obj/machinery/power/emitter/anchored{
	dir = 1;
	state = 2
	},
/obj/machinery/light{
	dir = 4
	},
/turf/open/floor/plating,
/area/engine/engineering)
"wt" = (
/obj/effect/turf_decal/stripes/line,
/obj/machinery/atmospherics/pipe/simple/cyan/visible{
	dir = 4
	},
/obj/structure/cable/layer1,
/turf/open/floor/engine,
/area/engine/engineering)
"wR" = (
/obj/effect/turf_decal/stripes/line{
	dir = 8
	},
/turf/open/floor/engine,
/area/engine/engineering)
"xC" = (
/obj/machinery/atmospherics/pipe/simple/green/visible{
	dir = 4
	},
/turf/closed/wall/r_wall,
/area/engine/supermatter)
"xS" = (
/obj/effect/turf_decal/stripes/line,
/obj/machinery/atmospherics/pipe/simple/cyan/visible{
	dir = 4
	},
/turf/open/floor/engine,
/area/engine/engineering)
"yb" = (
/obj/machinery/atmospherics/pipe/simple/general/visible{
	dir = 10
	},
/obj/machinery/meter,
/turf/closed/wall/r_wall,
/area/engine/supermatter)
"yG" = (
/obj/machinery/atmospherics/components/binary/pump{
	dir = 4;
	name = "Cooling Loop Bypass"
	},
/obj/effect/turf_decal/stripes/line{
	dir = 1
	},
/obj/machinery/light{
	dir = 1
	},
/turf/open/floor/engine,
/area/engine/engineering)
"yQ" = (
/obj/effect/turf_decal/stripes/line{
	dir = 9
	},
/obj/machinery/atmospherics/pipe/manifold/cyan/visible{
	dir = 8
	},
/turf/open/floor/engine,
/area/engine/engineering)
"Aj" = (
/obj/structure/cable,
/obj/effect/turf_decal/stripes/line{
	dir = 9
	},
/obj/structure/cable/layer1,
/turf/open/floor/engine,
/area/engine/engineering)
"As" = (
/obj/machinery/atmospherics/pipe/manifold/general/visible,
/obj/machinery/power/rad_collector/anchored,
/obj/structure/cable,
/obj/structure/window/plasma/reinforced{
	dir = 1
	},
/turf/open/floor/engine,
/area/engine/supermatter)
"AP" = (
/obj/structure/reflector/box/anchored{
	dir = 8
	},
/turf/open/floor/plasteel/dark,
/area/engine/engineering)
"Bj" = (
/obj/effect/turf_decal/stripes/line{
	dir = 1
	},
/obj/machinery/atmospherics/pipe/simple/green/visible{
	dir = 4
	},
/turf/open/floor/engine,
/area/engine/engineering)
"Cs" = (
/obj/effect/turf_decal/delivery,
/obj/machinery/atmospherics/pipe/manifold/scrubbers/visible{
	dir = 1
	},
/turf/open/floor/plasteel/dark,
/area/engine/engineering)
"CE" = (
/obj/machinery/status_display/evac,
/turf/closed/wall/r_wall,
/area/engine/supermatter)
"CV" = (
/obj/item/crowbar,
/obj/machinery/door/poddoor/shutters/preopen{
	id = "engsm";
	name = "Radiation Chamber Shutters"
	},
/obj/structure/cable/multilayer{
	cable_layer = 3
	},
/turf/open/floor/plating,
/area/engine/supermatter)
"CZ" = (
/obj/machinery/atmospherics/pipe/simple/general/visible{
	dir = 9
	},
/obj/machinery/power/rad_collector/anchored,
/obj/structure/cable,
/obj/structure/window/plasma/reinforced{
	dir = 1
	},
/turf/open/floor/engine,
/area/engine/supermatter)
"Da" = (
/turf/open/floor/engine,
/area/engine/supermatter)
"Du" = (
/obj/effect/turf_decal/stripes/line{
	dir = 8
	},
/obj/machinery/atmospherics/pipe/simple/cyan/visible,
/turf/open/floor/engine,
/area/engine/engineering)
"DC" = (
/obj/machinery/atmospherics/components/unary/vent_scrubber/on,
/turf/open/floor/engine,
/area/engine/supermatter)
"Et" = (
/obj/effect/turf_decal/stripes/line{
	dir = 1
	},
/obj/structure/cable,
/obj/structure/cable/layer1,
/turf/open/floor/engine,
/area/engine/engineering)
"ED" = (
/obj/effect/turf_decal/delivery,
/obj/machinery/atmospherics/pipe/simple/scrubbers/visible,
/turf/open/floor/plasteel/dark,
/area/engine/engineering)
"EX" = (
/obj/structure/sign/warning/electricshock,
/turf/closed/wall/r_wall,
/area/engine/supermatter)
"Fi" = (
/obj/effect/turf_decal/stripes/corner{
	dir = 4
	},
/obj/machinery/atmospherics/pipe/simple/green/visible{
	dir = 5
	},
/turf/open/floor/engine,
/area/engine/engineering)
"FF" = (
/turf/open/floor/plasteel/dark,
/area/engine/engineering)
"GJ" = (
/obj/machinery/atmospherics/pipe/simple/general/visible{
	dir = 10
	},
/obj/machinery/power/rad_collector/anchored,
/obj/structure/cable,
/obj/structure/window/plasma/reinforced,
/turf/open/floor/engine,
/area/engine/supermatter)
"Hw" = (
/obj/machinery/button/door{
	id = "engsm";
	name = "Radiation Shutters Control";
	pixel_x = 24;
	req_access_txt = "10"
	},
/obj/effect/turf_decal/stripes/line{
	dir = 4
	},
/obj/machinery/atmospherics/pipe/manifold/cyan/visible{
	dir = 8
	},
/turf/open/floor/engine,
/area/engine/engineering)
"IH" = (
/obj/effect/turf_decal/stripes/line{
	dir = 1
	},
/obj/structure/cable,
/obj/structure/cable/layer1,
/obj/structure/cable/layer1,
/turf/open/floor/engine,
/area/engine/engineering)
"IK" = (
/obj/effect/turf_decal/stripes/line{
	dir = 10
	},
/obj/structure/cable,
/obj/structure/cable/layer1,
/turf/open/floor/engine,
/area/engine/engineering)
"Jt" = (
/turf/closed/wall/r_wall,
/area/engine/engineering)
"JE" = (
/obj/structure/cable,
/obj/machinery/power/emitter/anchored{
	state = 2
	},
/turf/open/floor/plating,
/area/engine/engineering)
"JY" = (
/obj/effect/turf_decal/stripes/line{
	dir = 1
	},
/obj/structure/cable,
/turf/open/floor/engine,
/area/engine/engineering)
"KM" = (
/turf/open/floor/plating,
/area/engine/engineering)
"Md" = (
/obj/effect/turf_decal/stripes/line{
	dir = 4
	},
/obj/machinery/light{
	dir = 4
	},
/obj/machinery/atmospherics/pipe/simple/green/visible,
/obj/machinery/meter,
/turf/open/floor/engine,
/area/engine/engineering)
"Mj" = (
/obj/structure/reflector/single/anchored{
	dir = 9
	},
/turf/open/floor/plating,
/area/engine/engineering)
"Ms" = (
/obj/machinery/door/airlock/engineering/glass/critical{
	heat_proof = 1;
	name = "Supermatter Chamber";
	req_access_txt = "10"
	},
/obj/effect/mapping_helpers/airlock/cyclelink_helper{
	dir = 4
	},
/obj/effect/turf_decal/stripes/line{
	dir = 8
	},
/obj/effect/turf_decal/stripes/line{
	dir = 4
	},
/turf/open/floor/engine,
/area/engine/supermatter)
"My" = (
/obj/machinery/door/poddoor/shutters/preopen{
	id = "engsm";
	name = "Radiation Chamber Shutters"
	},
/obj/structure/cable/multilayer{
	cable_layer = 3
	},
/turf/open/floor/plating,
/area/engine/supermatter)
"Ne" = (
/obj/structure/cable,
/turf/open/floor/engine,
/area/engine/supermatter)
"Ng" = (
/obj/structure/cable,
/turf/open/floor/plating,
/area/engine/engineering)
"Nv" = (
/obj/effect/turf_decal/stripes/line{
	dir = 4
	},
/obj/machinery/atmospherics/components/trinary/filter/flipped/critical{
	filter_type = "n2"
	},
/turf/open/floor/engine,
/area/engine/engineering)
"Nx" = (
/obj/effect/turf_decal/stripes/line{
	dir = 1
	},
/obj/machinery/light{
	dir = 1
	},
/obj/structure/cable/layer1,
/obj/structure/cable,
/turf/open/floor/engine,
/area/engine/engineering)
"NA" = (
/obj/effect/turf_decal/stripes/line{
	dir = 4
	},
/obj/machinery/light{
	dir = 4
	},
/obj/machinery/atmospherics/pipe/simple/scrubbers/visible,
/turf/open/floor/engine,
/area/engine/engineering)
"NF" = (
/obj/effect/turf_decal/stripes/line{
	dir = 1
	},
/obj/machinery/meter,
/obj/machinery/light{
	dir = 1
	},
/obj/machinery/atmospherics/pipe/simple/green/visible{
	dir = 4
	},
/turf/open/floor/engine,
/area/engine/engineering)
"Oq" = (
/obj/effect/turf_decal/stripes/line{
	dir = 4
	},
/obj/machinery/atmospherics/components/trinary/filter/flipped/critical{
	dir = 1
	},
/turf/open/floor/engine,
/area/engine/engineering)
"Os" = (
/obj/effect/turf_decal/delivery,
/obj/machinery/atmospherics/pipe/simple/cyan/visible,
/turf/open/floor/plasteel/dark,
/area/engine/engineering)
"OL" = (
/obj/effect/spawner/structure/window/plasma/reinforced,
/turf/open/floor/plating,
/area/engine/engineering)
"ON" = (
/obj/effect/turf_decal/stripes/line,
/obj/structure/cable,
/obj/structure/cable/layer1,
/obj/machinery/atmospherics/components/unary/vent_pump/on,
/obj/machinery/firealarm{
	dir = 1;
	pixel_y = -24
	},
/turf/open/floor/engine,
/area/engine/engineering)
"PK" = (
/obj/effect/turf_decal/stripes/line{
	dir = 4
	},
/obj/machinery/meter,
/obj/machinery/atmospherics/pipe/simple/orange/visible,
/turf/open/floor/engine,
/area/engine/engineering)
"Qy" = (
/obj/effect/turf_decal/stripes/line{
	dir = 10
	},
/obj/machinery/camera{
	c_tag = "Engineering Supermatter Starboard";
	dir = 4;
	network = list("ss13","engine")
	},
/obj/machinery/atmospherics/pipe/simple/cyan/visible,
/turf/open/floor/engine,
/area/engine/engineering)
"QL" = (
/obj/machinery/door/airlock/engineering/glass/critical{
	heat_proof = 1;
	name = "Supermatter Chamber";
	req_access_txt = "10"
	},
/obj/effect/mapping_helpers/airlock/cyclelink_helper{
	dir = 8
	},
/obj/effect/turf_decal/stripes/line{
	dir = 8
	},
/obj/effect/turf_decal/stripes/line{
	dir = 4
	},
/turf/open/floor/engine,
/area/engine/supermatter)
"Ri" = (
/obj/machinery/camera{
	c_tag = "Supermatter Chamber";
	dir = 4;
	network = list("engine")
	},
/obj/structure/cable,
/turf/open/floor/engine,
/area/engine/supermatter)
"RT" = (
/obj/effect/turf_decal/stripes/line{
	dir = 1
	},
/obj/machinery/atmospherics/pipe/manifold/green/visible{
	dir = 1
	},
/turf/open/floor/engine,
/area/engine/engineering)
"SG" = (
/obj/effect/turf_decal/stripes/line{
	dir = 8
	},
/obj/machinery/atmospherics/pipe/manifold/cyan/visible{
	dir = 8
	},
/turf/open/floor/engine,
/area/engine/engineering)
"SM" = (
/obj/item/radio/intercom{
	pixel_y = 21
	},
/turf/open/floor/plasteel/dark,
/area/engine/engineering)
"SO" = (
/obj/effect/turf_decal/delivery,
/obj/machinery/atmospherics/components/binary/pump{
	dir = 8;
	name = "External Gas to Loop"
	},
/turf/open/floor/plasteel/dark,
/area/engine/engineering)
"Ug" = (
/obj/effect/turf_decal/stripes/line{
	dir = 5
	},
/obj/machinery/atmospherics/components/trinary/filter/flipped/critical,
/turf/open/floor/engine,
/area/engine/engineering)
"Uq" = (
/turf/closed/wall/r_wall,
/area/engine/supermatter)
"VE" = (
/obj/effect/turf_decal/stripes/line{
	dir = 1
	},
/obj/structure/cable,
/obj/structure/cable/layer1,
/obj/machinery/atmospherics/components/binary/pump{
	name = "Mix to Gas"
	},
/turf/open/floor/engine,
/area/engine/engineering)
"Wj" = (
/obj/structure/cable,
/obj/effect/turf_decal/stripes/line{
	dir = 4
	},
/obj/machinery/atmospherics/pipe/manifold/orange/visible{
	dir = 4
	},
/turf/open/floor/engine,
/area/engine/engineering)
"Wm" = (
/obj/machinery/atmospherics/components/unary/vent_pump/on{
	dir = 1
	},
/turf/open/floor/engine,
/area/engine/supermatter)
"WA" = (
/obj/machinery/atmospherics/components/binary/pump/on{
	name = "Gas to Filter"
	},
/obj/effect/turf_decal/stripes/line{
	dir = 4
	},
/turf/open/floor/engine,
/area/engine/engineering)
"WT" = (
/obj/machinery/atmospherics/components/binary/pump{
	dir = 4;
	name = "Gas to Chamber"
	},
/turf/open/floor/engine,
/area/engine/supermatter)
"Xl" = (
/obj/machinery/atmospherics/pipe/manifold/general/visible{
	dir = 1
	},
/obj/machinery/power/rad_collector/anchored,
/obj/structure/cable,
/obj/structure/window/plasma/reinforced,
/turf/open/floor/engine,
/area/engine/supermatter)
"YL" = (
/obj/structure/cable,
/obj/effect/turf_decal/stripes/corner{
	dir = 8
	},
/obj/machinery/atmospherics/pipe/simple/cyan/visible{
	dir = 10
	},
/turf/open/floor/engine,
/area/engine/engineering)
"YO" = (
/obj/effect/turf_decal/stripes/line{
	dir = 4
	},
/obj/machinery/atmospherics/pipe/simple/cyan/visible,
/obj/machinery/meter,
/turf/open/floor/engine,
/area/engine/engineering)
"YQ" = (
/obj/effect/turf_decal/stripes/line{
	dir = 1
	},
/obj/machinery/atmospherics/pipe/simple/green/visible{
	dir = 4
	},
/obj/structure/cable/layer1,
/turf/open/floor/engine,
/area/engine/engineering)
"Zc" = (
/obj/structure/sign/warning/fire,
/turf/closed/wall/r_wall,
/area/engine/supermatter)
"Zf" = (
/obj/effect/turf_decal/stripes/line,
/obj/structure/cable,
/obj/structure/cable/layer1,
/turf/open/floor/engine,
/area/engine/engineering)
"Zj" = (
/obj/effect/turf_decal/bot{
	dir = 1
	},
/obj/machinery/atmospherics/components/unary/portables_connector/visible{
	dir = 8
	},
/obj/machinery/portable_atmospherics/canister,
/turf/open/floor/plasteel/dark,
/area/engine/engineering)
"ZV" = (
/obj/effect/turf_decal/stripes/line{
	dir = 4
	},
/obj/machinery/camera{
	c_tag = "Engineering Supermatter Port";
	dir = 8;
	network = list("ss13","engine")
	},
/obj/machinery/airalarm/engine{
	dir = 8;
	pixel_x = 24
	},
/obj/machinery/atmospherics/pipe/manifold/green/visible{
	dir = 8
	},
/turf/open/floor/engine,
/area/engine/engineering)

(1,1,1) = {"
Aj
wR
wR
wR
wR
wR
wR
wR
wR
wR
wR
wR
IK
"}
(2,1,1) = {"
Et
gR
cW
cW
YO
Hw
WA
ZV
Md
Oq
aj
Fi
Zf
"}
(3,1,1) = {"
Et
xS
SO
SO
Uq
md
Ms
xC
Uq
Cs
qp
Bj
Zf
"}
(4,1,1) = {"
Nx
xS
jL
jL
Uq
WT
Da
px
Uq
Zj
Zj
RT
bO
"}
(5,1,1) = {"
VE
tC
CE
Uq
qN
ri
QL
yb
np
Uq
CE
NF
Zf
"}
(6,1,1) = {"
qI
xS
nS
Ne
Xl
Wm
Da
DC
As
Ri
nS
Bj
ON
"}
(7,1,1) = {"
IH
wt
My
Ne
Xl
Wm
ed
DC
As
Ne
CV
YQ
nY
"}
(8,1,1) = {"
JY
aV
nS
Ne
GJ
Wm
Da
DC
CZ
Ne
nS
RT
mt
"}
(9,1,1) = {"
mi
tt
CE
Uq
Uq
Zc
kJ
EX
Uq
Uq
CE
yG
qA
"}
(10,1,1) = {"
ap
YL
SG
Du
SG
Qy
Os
yQ
Du
uL
wR
gA
qA
"}
(11,1,1) = {"
qQ
aG
cU
qx
lb
fF
ED
Ug
NA
Nv
PK
Wj
hi
"}
(12,1,1) = {"
OL
eQ
OL
Jt
Jt
OL
OL
OL
Jt
Jt
OL
eQ
OL
"}
(13,1,1) = {"
FF
Ng
KM
FF
FF
FF
AP
po
FF
FF
KM
Ng
FF
"}
(14,1,1) = {"
lW
Ng
Ng
FF
FF
FF
FF
FF
FF
FF
Ng
Ng
na
"}
(15,1,1) = {"
SM
KM
JE
FF
FF
FF
AP
FF
FF
FF
pf
KM
sf
"}
(16,1,1) = {"
KM
KM
er
KM
KM
Mj
Jt
rb
KM
KM
vj
KM
FF
"}
