//MAP CONVERTED BY dmm2tgm.py THIS HEADER COMMENT PREVENTS RECONVERSION, DO NOT REMOVE
"ai" = (
/obj/machinery/atmospherics/pipe/simple/purple/visible/layer1{
	dir = 8
	},
/turf/open/floor/engine,
/area/engine/engineering)
"aj" = (
/obj/machinery/atmospherics/pipe/simple/cyan/visible,
/obj/effect/turf_decal/arrows/white{
	pixel_x = 5
	},
/turf/open/floor/engine,
/area/engine/engineering)
"aG" = (
/obj/effect/turf_decal/stripes/line{
	dir = 8
	},
/obj/structure/cable/layer1,
/turf/open/floor/engine,
/area/engine/engineering)
"aL" = (
/obj/machinery/light,
/obj/machinery/atmospherics/components/unary/portables_connector/visible{
	dir = 8
	},
/obj/effect/turf_decal/stripes/box,
/turf/open/floor/engine,
/area/engine/engineering)
"bg" = (
/obj/machinery/atmospherics/pipe/simple/cyan/visible{
	dir = 4
	},
/obj/machinery/meter,
/turf/open/floor/engine,
/area/engine/engineering)
"bH" = (
/obj/machinery/atmospherics/components/binary/circulator{
	dir = 8
	},
/obj/effect/turf_decal/stripes/end{
	dir = 4
	},
/turf/open/floor/engine,
/area/engine/engineering)
"dm" = (
/obj/machinery/atmospherics/pipe/heat_exchanging/simple{
	dir = 9
	},
/turf/open/floor/engine,
/area/engine/engineering)
"es" = (
/obj/machinery/atmospherics/pipe/simple/cyan/visible{
	dir = 5
	},
/obj/machinery/atmospherics/pipe/simple/purple/visible/layer1{
	dir = 8
	},
/turf/open/floor/engine,
/area/engine/engineering)
"fZ" = (
/obj/effect/turf_decal/arrows/red{
	dir = 1;
	icon_state = "arrows_red";
	pixel_x = -5
	},
/obj/machinery/atmospherics/components/binary/pump/on{
	dir = 1
	},
/turf/open/floor/engine,
/area/engine/engineering)
"gf" = (
/obj/machinery/atmospherics/pipe/heat_exchanging/simple{
	dir = 4
	},
/obj/machinery/atmospherics/pipe/simple/scrubbers/visible,
/turf/open/floor/engine,
/area/engine/engineering)
"gq" = (
/obj/machinery/atmospherics/components/unary/portables_connector/visible{
	dir = 4
	},
/obj/machinery/portable_atmospherics/canister/nitrogen,
/obj/effect/turf_decal/stripes/box,
/turf/open/floor/engine,
/area/engine/engineering)
"iy" = (
/obj/machinery/atmospherics/pipe/manifold/orange/visible{
	dir = 8
	},
/turf/open/floor/engine,
/area/engine/engineering)
"iV" = (
/obj/machinery/atmospherics/components/unary/outlet_injector/on,
/turf/open/floor/engine,
/area/engine/engineering)
"iX" = (
/obj/machinery/atmospherics/components/unary/portables_connector/visible{
	dir = 8
	},
/obj/effect/turf_decal/stripes/box,
/turf/open/floor/engine,
/area/engine/engineering)
"jd" = (
/obj/machinery/atmospherics/pipe/heat_exchanging/simple{
	dir = 4
	},
/obj/machinery/atmospherics/pipe/simple/purple/visible,
/turf/open/floor/engine,
/area/engine/engineering)
"jp" = (
/obj/machinery/atmospherics/components/binary/pump{
	dir = 4
	},
/turf/open/floor/engine,
/area/engine/engineering)
"jy" = (
/obj/machinery/atmospherics/components/binary/pump{
	dir = 4;
	layer = 2.4
	},
/turf/open/floor/engine,
/area/engine/engineering)
"jP" = (
/obj/machinery/door/poddoor{
	id = "burnrelease"
	},
/turf/open/floor/engine,
/area/engine/engineering)
"kA" = (
/obj/machinery/atmospherics/pipe/manifold/orange/visible{
	dir = 4
	},
/turf/open/floor/engine,
/area/engine/engineering)
"kE" = (
/obj/machinery/atmospherics/pipe/layer_manifold/visible,
/turf/open/floor/engine,
/area/engine/engineering)
"kF" = (
/obj/effect/turf_decal/stripes/line,
/obj/machinery/atmospherics/pipe/simple/purple/visible{
	dir = 5
	},
/turf/open/floor/engine,
/area/engine/engineering)
"kW" = (
/obj/machinery/atmospherics/components/unary/portables_connector/visible{
	dir = 4
	},
/obj/machinery/portable_atmospherics/canister/toxins,
/obj/effect/turf_decal/stripes/box,
/turf/open/floor/engine,
/area/engine/engineering)
"lj" = (
/obj/effect/turf_decal/arrows/white{
	pixel_x = 5
	},
/obj/machinery/atmospherics/pipe/manifold/cyan/visible{
	dir = 4
	},
/turf/open/floor/engine,
/area/engine/engineering)
"lv" = (
/obj/effect/turf_decal/stripes/line{
	dir = 5
	},
/turf/open/floor/engine,
/area/engine/engineering)
"lC" = (
/obj/machinery/airalarm{
	dir = 8;
	pixel_x = 24
	},
/obj/effect/turf_decal/stripes/line{
	dir = 4
	},
/obj/machinery/light{
	dir = 4
	},
/turf/open/floor/engine,
/area/engine/engineering)
"lO" = (
/obj/effect/turf_decal/stripes/line{
	dir = 1
	},
/obj/machinery/atmospherics/pipe/simple/scrubbers/visible{
	dir = 5
	},
/turf/open/floor/engine,
/area/engine/engineering)
"lV" = (
/obj/machinery/atmospherics/pipe/manifold/orange/visible,
/obj/effect/turf_decal/arrows/red{
	dir = 4;
	pixel_y = -5
	},
/turf/open/floor/engine,
/area/engine/engineering)
"lZ" = (
/obj/machinery/atmospherics/pipe/simple/orange/visible,
/turf/open/floor/engine,
/area/engine/engineering)
"nb" = (
/obj/effect/spawner/structure/window/plasma/reinforced,
/obj/machinery/door/poddoor/shutters/preopen{
	id = "burnchamb"
	},
/turf/open/floor/plating,
/area/engine/engineering)
"nn" = (
/obj/machinery/atmospherics/pipe/manifold4w/orange/visible,
/obj/machinery/meter,
/turf/open/floor/engine,
/area/engine/engineering)
"oh" = (
/obj/effect/turf_decal/stripes/line{
	dir = 1
	},
/obj/machinery/light{
	dir = 1
	},
/turf/open/floor/engine,
/area/engine/engineering)
"oT" = (
/obj/effect/turf_decal/stripes/line{
	dir = 1
	},
/obj/machinery/atmospherics/components/binary/pump/on{
	dir = 1
	},
/turf/open/floor/engine,
/area/engine/engineering)
"pk" = (
/obj/machinery/atmospherics/pipe/manifold/purple{
	dir = 1
	},
/turf/open/floor/engine,
/area/engine/engineering)
"pz" = (
/obj/machinery/atmospherics/pipe/simple/cyan/visible,
/obj/machinery/atmospherics/pipe/simple/purple/visible/layer1{
	dir = 8
	},
/turf/open/floor/engine,
/area/engine/engineering)
"pL" = (
/obj/machinery/atmospherics/pipe/heat_exchanging/simple{
	dir = 4
	},
/turf/open/floor/engine,
/area/engine/engineering)
"pN" = (
/obj/machinery/atmospherics/pipe/simple/cyan/visible,
/turf/open/floor/engine,
/area/engine/engineering)
"qV" = (
/obj/machinery/atmospherics/pipe/simple/purple/visible/layer1{
	dir = 6
	},
/turf/open/floor/engine,
/area/engine/engineering)
"rT" = (
/obj/machinery/atmospherics/pipe/simple/purple/visible{
	dir = 9
	},
/turf/open/floor/engine,
/area/engine/engineering)
"sl" = (
/obj/machinery/atmospherics/pipe/simple/cyan/visible,
/obj/machinery/meter,
/turf/open/floor/engine,
/area/engine/engineering)
"sy" = (
/obj/machinery/atmospherics/components/binary/circulator/cold{
	dir = 4
	},
/obj/effect/turf_decal/stripes/end{
	dir = 8
	},
/turf/open/floor/engine,
/area/engine/engineering)
"sL" = (
/turf/open/floor/engine,
/area/engine/engineering)
"sM" = (
/obj/machinery/atmospherics/pipe/layer_manifold/visible{
	dir = 4
	},
/turf/open/floor/engine,
/area/engine/engineering)
"tv" = (
/obj/effect/turf_decal/stripes/line{
	dir = 4
	},
/obj/machinery/light{
	dir = 4
	},
/obj/machinery/button/door{
	id = "burnchamb";
	name = "Burn Chamber Shutters Control";
	pixel_x = 24;
	req_access_txt = "10"
	},
/turf/open/floor/engine,
/area/engine/engineering)
"tI" = (
/obj/effect/turf_decal/stripes/line,
/turf/open/floor/engine,
/area/engine/engineering)
"tJ" = (
/obj/machinery/atmospherics/pipe/simple/orange/visible{
	dir = 9
	},
/turf/open/floor/engine,
/area/engine/engineering)
"tZ" = (
/obj/machinery/atmospherics/pipe/simple/cyan/visible{
	dir = 6
	},
/turf/open/floor/engine,
/area/engine/engineering)
"ux" = (
/obj/effect/turf_decal/stripes/line{
	dir = 1
	},
/obj/machinery/atmospherics/pipe/simple/scrubbers/visible{
	dir = 10
	},
/turf/open/floor/engine,
/area/engine/engineering)
"uT" = (
/obj/effect/turf_decal/stripes/line{
	dir = 4
	},
/turf/open/floor/engine,
/area/engine/engineering)
"vT" = (
/obj/machinery/atmospherics/pipe/simple/scrubbers/visible,
/obj/effect/turf_decal/stripes/line{
	dir = 6
	},
/turf/open/floor/engine,
/area/engine/engineering)
"vU" = (
/obj/effect/turf_decal/stripes/line{
	dir = 8
	},
/turf/open/floor/engine,
/area/engine/engineering)
"wb" = (
/obj/machinery/atmospherics/pipe/simple/cyan/visible{
	dir = 5
	},
/turf/open/floor/engine,
/area/engine/engineering)
"xr" = (
/obj/effect/turf_decal/stripes/line,
/obj/machinery/atmospherics/components/binary/pump/on{
	dir = 2
	},
/obj/machinery/light,
/turf/open/floor/engine,
/area/engine/engineering)
"xE" = (
/obj/effect/turf_decal/stripes/line,
/obj/machinery/atmospherics/components/binary/pump{
	dir = 1
	},
/turf/open/floor/engine,
/area/engine/engineering)
"Ax" = (
/obj/machinery/atmospherics/pipe/simple/orange/visible{
	dir = 4
	},
/obj/effect/turf_decal/stripes/line{
	dir = 4
	},
/turf/open/floor/engine,
/area/engine/engineering)
"BE" = (
/obj/machinery/meter,
/obj/machinery/atmospherics/pipe/simple/orange/visible{
	dir = 10
	},
/turf/open/floor/engine,
/area/engine/engineering)
"BI" = (
/obj/effect/turf_decal/stripes/line,
/obj/machinery/light,
/turf/open/floor/engine,
/area/engine/engineering)
"BY" = (
/obj/effect/spawner/structure/window/plasma/reinforced,
/obj/machinery/atmospherics/pipe/heat_exchanging/junction{
	dir = 4
	},
/obj/machinery/door/poddoor/shutters/preopen{
	id = "burnchamb"
	},
/turf/open/floor/plating,
/area/engine/engineering)
"CA" = (
/obj/effect/turf_decal/stripes/line{
	dir = 9
	},
/obj/machinery/light{
	dir = 1
	},
/turf/open/floor/engine,
/area/engine/engineering)
"CO" = (
/obj/machinery/atmospherics/components/unary/vent_scrubber/on{
	dir = 1
	},
/turf/open/floor/engine,
/area/engine/engineering)
"DP" = (
/obj/effect/turf_decal/stripes/line{
	dir = 1
	},
/turf/open/floor/engine,
/area/engine/engineering)
"Eq" = (
/obj/machinery/atmospherics/pipe/simple/scrubbers/visible,
/obj/machinery/button/door{
	id = "burnrelease";
	name = "Burn Chamber Release Shutters Control";
	pixel_x = 24;
	req_access_txt = "10"
	},
/obj/effect/turf_decal/stripes/line{
	dir = 4
	},
/turf/open/floor/engine,
/area/engine/engineering)
"Er" = (
/obj/machinery/atmospherics/pipe/simple/cyan/visible,
/obj/effect/turf_decal/arrows/white{
	dir = 1;
	pixel_x = 5
	},
/turf/open/floor/engine,
/area/engine/engineering)
"FL" = (
/obj/machinery/atmospherics/pipe/manifold4w/cyan/visible,
/turf/open/floor/engine,
/area/engine/engineering)
"Gi" = (
/obj/machinery/atmospherics/pipe/simple/cyan/visible{
	dir = 9
	},
/turf/open/floor/engine,
/area/engine/engineering)
"GE" = (
/obj/machinery/atmospherics/pipe/simple/purple/visible{
	dir = 8
	},
/turf/open/floor/engine,
/area/engine/engineering)
"HO" = (
/obj/machinery/atmospherics/pipe/simple/orange/visible{
	dir = 10
	},
/obj/machinery/meter,
/turf/open/floor/engine,
/area/engine/engineering)
"Ic" = (
/obj/structure/cable/multilayer{
	cable_layer = 3
	},
/turf/open/floor/engine,
/area/engine/engineering)
"Io" = (
/obj/effect/turf_decal/stripes/line,
/obj/machinery/atmospherics/components/binary/pump/on{
	dir = 1
	},
/turf/open/floor/engine,
/area/engine/engineering)
"Kf" = (
/obj/effect/turf_decal/stripes/end{
	dir = 4
	},
/turf/open/floor/engine,
/area/engine/engineering)
"KL" = (
/obj/machinery/atmospherics/components/binary/pump{
	dir = 8
	},
/turf/open/floor/engine,
/area/engine/engineering)
"Lh" = (
/obj/machinery/atmospherics/pipe/simple/cyan/visible{
	dir = 10
	},
/obj/machinery/atmospherics/pipe/simple/purple/visible/layer1{
	dir = 8
	},
/turf/open/floor/engine,
/area/engine/engineering)
"Nk" = (
/turf/closed/wall/r_wall,
/area/engine/engineering)
"ND" = (
/obj/machinery/atmospherics/pipe/simple/purple/visible{
	dir = 5
	},
/turf/open/floor/engine,
/area/engine/engineering)
"NX" = (
/obj/effect/turf_decal/stripes/line,
/obj/effect/turf_decal/stripes/line{
	dir = 1
	},
/turf/open/floor/engine,
/area/engine/engineering)
"Of" = (
/obj/machinery/atmospherics/pipe/simple/orange/visible{
	dir = 5
	},
/turf/open/floor/engine,
/area/engine/engineering)
"ON" = (
/obj/machinery/power/generator,
/obj/structure/cable,
/obj/effect/turf_decal/stripes{
	dir = 1
	},
/obj/effect/turf_decal/stripes,
/turf/open/floor/engine,
/area/engine/engineering)
"Pf" = (
/turf/open/space/basic,
/area/engine/engineering)
"PG" = (
/obj/effect/spawner/structure/window/plasma/reinforced,
/obj/machinery/atmospherics/pipe/simple/purple/visible,
/obj/machinery/door/poddoor/shutters/preopen{
	id = "burnchamb"
	},
/turf/open/floor/plating,
/area/engine/engineering)
"Qt" = (
/obj/machinery/atmospherics/pipe/simple/cyan/visible,
/obj/structure/cable/layer1,
/obj/machinery/meter,
/turf/open/floor/engine,
/area/engine/engineering)
"QI" = (
/obj/machinery/atmospherics/pipe/simple/purple/visible,
/obj/machinery/meter,
/turf/open/floor/engine,
/area/engine/engineering)
"QV" = (
/obj/machinery/atmospherics/pipe/simple/orange/visible,
/obj/machinery/meter,
/turf/open/floor/engine,
/area/engine/engineering)
"Rk" = (
/obj/machinery/atmospherics/pipe/simple/cyan/visible{
	dir = 4
	},
/obj/effect/turf_decal/arrows/white{
	dir = 8;
	icon_state = "arrows_white";
	pixel_y = -5
	},
/obj/machinery/atmospherics/pipe/simple/purple/visible/layer1{
	dir = 8
	},
/turf/open/floor/engine,
/area/engine/engineering)
"Sm" = (
/obj/machinery/atmospherics/pipe/heat_exchanging/simple,
/turf/open/floor/engine,
/area/engine/engineering)
"UE" = (
/obj/effect/turf_decal/stripes/line{
	dir = 1
	},
/obj/machinery/atmospherics/components/binary/pump/on{
	dir = 2
	},
/turf/open/floor/engine,
/area/engine/engineering)
"UI" = (
/obj/effect/spawner/structure/window/plasma/reinforced,
/obj/machinery/atmospherics/pipe/simple/scrubbers/visible,
/obj/machinery/door/poddoor/shutters/preopen{
	id = "burnchamb"
	},
/turf/open/floor/plating,
/area/engine/engineering)
"UK" = (
/obj/effect/turf_decal/arrows/red{
	dir = 1;
	icon_state = "arrows_red";
	pixel_x = -5
	},
/obj/machinery/atmospherics/pipe/manifold/orange/visible{
	dir = 8
	},
/turf/open/floor/engine,
/area/engine/engineering)
"UQ" = (
/obj/machinery/atmospherics/pipe/simple/cyan/visible{
	dir = 10
	},
/turf/open/floor/engine,
/area/engine/engineering)
"Vk" = (
/obj/structure/cable/layer1,
/turf/open/floor/engine,
/area/engine/engineering)
"VA" = (
/obj/effect/turf_decal/stripes/line{
	dir = 4
	},
/obj/effect/spawner/structure/window/plasma/reinforced,
/obj/machinery/door/poddoor/shutters/preopen{
	id = "burnchamb"
	},
/turf/open/floor/plating,
/area/engine/engineering)
"VB" = (
/obj/machinery/atmospherics/pipe/manifold/orange/visible{
	dir = 8
	},
/obj/effect/turf_decal/arrows/red{
	dir = 1;
	icon_state = "arrows_red";
	pixel_x = -5
	},
/turf/open/floor/engine,
/area/engine/engineering)
"Wr" = (
/obj/machinery/atmospherics/pipe/simple/cyan/visible,
/obj/structure/cable/layer1,
/turf/open/floor/engine,
/area/engine/engineering)
"WB" = (
/obj/machinery/atmospherics/pipe/simple/orange/visible{
	dir = 10
	},
/turf/open/floor/engine,
/area/engine/engineering)
"WY" = (
/obj/effect/turf_decal/stripes/line{
	dir = 1
	},
/obj/machinery/atmospherics/pipe/simple/scrubbers/visible{
	dir = 4
	},
/turf/open/floor/engine,
/area/engine/engineering)
"Xv" = (
/obj/effect/turf_decal/stripes/line{
	dir = 10
	},
/obj/structure/cable/layer1,
/obj/machinery/light,
/turf/open/floor/engine,
/area/engine/engineering)
"XR" = (
/obj/machinery/atmospherics/pipe/simple/orange/visible{
	dir = 4
	},
/obj/effect/turf_decal/arrows/red{
	dir = 4;
	pixel_y = -5
	},
/turf/open/floor/engine,
/area/engine/engineering)
"Yf" = (
/obj/machinery/atmospherics/pipe/heat_exchanging/simple{
	dir = 10
	},
/turf/open/floor/engine,
/area/engine/engineering)
"ZK" = (
/obj/machinery/atmospherics/components/binary/pump{
	dir = 1
	},
/obj/effect/turf_decal/stripes/line{
	dir = 1
	},
/turf/open/floor/engine,
/area/engine/engineering)

(1,1,1) = {"
CA
vU
vU
vU
vU
vU
aG
aG
aG
aG
aG
aG
Xv
"}
(2,1,1) = {"
DP
gq
gq
gq
sL
sL
Vk
sL
sL
sL
sL
sL
tI
"}
(3,1,1) = {"
DP
WB
nn
tJ
sL
sL
Vk
kW
kW
kW
sL
sL
tI
"}
(4,1,1) = {"
DP
sL
jp
sL
sL
sL
Vk
UQ
FL
Gi
qV
kE
xE
"}
(5,1,1) = {"
UE
lZ
lV
sL
sL
sL
Vk
sL
jy
sL
ai
sL
tI
"}
(6,1,1) = {"
DP
sL
XR
tZ
pN
pN
Wr
aj
lj
aj
pz
wb
tI
"}
(7,1,1) = {"
DP
sL
XR
UQ
sl
sy
Qt
Er
Er
Er
es
bg
tI
"}
(8,1,1) = {"
DP
sL
WB
iy
Of
ON
Ic
sL
sL
sL
Rk
UQ
xr
"}
(9,1,1) = {"
oT
Of
sL
KL
BE
bH
QV
Of
sL
sL
Rk
sL
tI
"}
(10,1,1) = {"
DP
HO
lZ
kA
UK
fZ
VB
tJ
sL
sL
Rk
sL
tI
"}
(11,1,1) = {"
lO
sL
sL
sL
KL
sL
jp
sL
sL
sL
Lh
pN
Io
"}
(12,1,1) = {"
WY
sL
sL
tv
Ax
uT
Ax
lC
sL
sL
sM
sL
tI
"}
(13,1,1) = {"
WY
sL
BI
Nk
BY
nb
BY
Nk
oh
sL
pk
ND
tI
"}
(14,1,1) = {"
ux
Eq
vT
UI
gf
CO
pL
nb
DP
sL
GE
KL
tI
"}
(15,1,1) = {"
NX
Nk
nb
Nk
pL
iV
jd
PG
ZK
QI
rT
pk
kF
"}
(16,1,1) = {"
Kf
Nk
Pf
jP
Yf
Sm
dm
VA
lv
uT
uT
iX
aL
"}
